The Elder Scrolls V Skyrim: The Elder Scrolls V Skyrim - Dawnguard, The Elder Scrolls V Skyrim - Dragonborn, The Elder Scrolls V Skyrim - Hearthfire
Fallout 4: Fallout, Fallout 3, Fallout 2, Fallout New Vegas, Fallout 3 - Game of the Year Edition, Fallout New Vegas Courier's Stash
Spore: Spore Galactic Adventures, Spore Creepy & Cute Parts Pack
Left 4 Dead 2: Left 4 Dead
HuniePop: HuniePop Official Digital Art Collection, HuniePop Original Soundtrack
Team Fortress 2: FaceRig Team Fortress 2 Avatars DLC, Team Fortress Classic, Two Worlds 2 - Pirates of the Flying Fortress 
Tomb Raider: Tomb Raider I, Tomb Raider (VI) The Angel of Darkness, Tomb Raider Anniversary, Tomb Raider Chronicles, Tomb Raider Legend, Tomb Raider The Last Revelation
The Banner Saga: The Banner Saga - Mod Content, The Banner Saga Factions
Dead Island Epidemic: Dead Island, Dead Island Riptide
BioShock Infinite: BioShock, BioShock Infinite - Season Pass, BioShock Infinite Burial at Sea - Episode 1, BioShock Infinite Burial at Sea - Episode 2, BioShock 2
Dragon Age Origins - Ultimate Edition: Dragon Age Origins, Dragon Age II, Dragon Age Origins - Awakening
Grand Theft Auto IV: Grand Theft Auto, Grand Theft Auto V, Grand Theft Auto 2, Grand Theft Auto III, Grand Theft Auto Episodes from Liberty City, Grand Theft Auto San Andreas
Realm of the Mad God: Lords of the Realm
Dota 2: Dota 2 - Short Film Contest, Dota 2 - The International 2015 - Player Profiles
Fallout New Vegas Dead Money: Fallout New Vegas, Fallout, Fallout 4, Fallout 3, Fallout 2, Fallout New Vegas Honest Hearts
Ultra Street Fighter IV: Street Fighter IV, Street Fighter V Beta
FINAL FANTASY XIII: LIGHTNING RETURNS FINAL FANTASY XIII, FINAL FANTASY III, FINAL FANTASY XIII-2, FINAL FANTASY VIII, FINAL FANTASY XI, FINAL FANTASY V
Sid Meier's Civilization V: Sid Meier's Civilization V Brave New World, Sid Meier's Civilization V Scrambled Continents Map Pack, Sid Meier's Civilization IV, Sid Meier's Civilization III Complete, Sid Meier's Civilization IV Beyond the Sword, Sid Meier's Civilization IV Warlords
Company of Heroes Tales of Valor: Company of Heroes, Company of Heroes 2
FINAL FANTASY VII: FINAL FANTASY VIII, FINAL FANTASY III, FINAL FANTASY V, FINAL FANTASY XIII, FINAL FANTASY XI, FINAL FANTASY IV
Orcs Must Die! 2: Orcs Must Die!
Killing Floor: Killing Floor Mod Defence Alliance 2, Killing Floor 2, Killing Floor - Toy Master, Killing Floor Uncovered, Killing Floor Beta
Counter-Strike Global Offensive: Counter-Strike, Counter-Strike Source
THE KING OF FIGHTERS XIII STEAM EDITION: THE KING OF FIGHTERS '98 ULTIMATE MATCH FINAL EDITION
Skullgirls: Skullgirls Endless Beta
Assassin's Creed II: Assassin's Creed, Assassin's Creed III, Assassin's Creed IV Black Flag, Assassin's Creed Brotherhood, Assassin's Creed Freedom Cry, Assassin's Creed Revelations
Company of Heroes Opposing Fronts: Company of Heroes, Company of Heroes 2
Psychonauts: Psychonauts Demo
Cities in Motion 2: Cities in Motion, Cities in Motion 2 Marvellous Monorails, Cities XL
Company of Heroes (New Steam Version): Company of Heroes, Steam Heroes, Company of Heroes 2
Magicka: Magicka Vietnam, Magicka Final Frontier, Magicka Frozen Lake, Magicka Nippon, Magicka Party Robes, Magicka The Watchtower
Natural Selection 2: Natural Selection 2 - Kodiak Pack, Natural Selection 2 - Reaper Pack
Sanctum: Sanctum 2, Super Sanctum TD, Ghostbusters Sanctum of Slime
Serious Sam 3 BFE: Serious Sam 2
Insurgency: Insurgency Modern Infantry Combat
Saints Row The Third: Saints Row The Third - Initiation Station, Saints Row 2, Saints Row IV
Far Cry 3: Far Cry 3 Blood Dragon, Far Cry, Far Cry 4, Far Cry 2, Far Cry 2 Fortunes Pack
Prototype: Prototype 2 RADNET Access Pack, The Talos Principle - Prototype
Dying Light: Light
Just Cause 2: Just Cause, Just Cause 2 Multiplayer Mod, Just Cause 3
Portal 2: Portal, Portal 2 - The Final Hours, Portal 2 Sixense Perceptual Pack, Portal 2 Sixense MotionPack, Portal Stories Mel, Portal of Evil Stolen Runes Collector's Edition
Deus Ex Human Revolution: Deus Ex Human Revolution - Director's Cut, Deus Ex Human Revolution - The Missing Link, Revolution Ace
Batman Arkham City GOTY: Batman Arkham City, Batman Arkham Asylum GOTY Edition
Tropico 4: Tropico, Tropico 5, Tropico 3 - Steam Special Edition, Tropico 3 Absolute Power, Tropico 2 Pirate Cove, Tropico 5 - Generalissimo
F.E.A.R.: F.E.A.R. 2 Project Origin, F.E.A.R. 3, F.E.A.R. Extraction Point, F.E.A.R. Perseus Mandate, F.E.A.R. Online
South Park The Stick of Truth: South Park The Stick of Truth - Super Samurai Spaceman Pack, South Park The Stick of Truth - Ultimate Fellowship Pack
Sleeping Dogs: Sleeping Dogs Definitive Edition
DayZ: Arma 2 DayZ Mod
Half-Life 2: Half-Life 2 Episode Two, Half-Life 2 Episode One, Half-Life 2 Lost Coast, Half-Life, Half-Life 2 Deathmatch, Half-Life 2 Update
The Talos Principle: The Talos Principle Road To Gehenna, The Talos Principle - Bonus Content, The Talos Principle - Prototype, The Talos Principle - Soundtrack
DiRT 3: DiRT 3 Complete Edition, DiRT, DiRT 2, DiRT Showdown, DiRT Rally
FTL Faster Than Light: Light
Age of Empires II HD Edition: Empires, Age of Empires II HD The Forgotten, Age of Empires Online
Rebuild 3 Gangs of Deadsville: Rebuild Gangs of Deadsville - Deluxe DLC
Metro 2033: Metro 2033 Redux
Ori and the Blind Forest: Ori and the Blind Forest (Original Soundtrack)
Burnout Paradise The Ultimate Box: The Ultimate DOOM
Game Dev Tycoon: Automation - The Car Company Tycoon Game, Game Tycoon 1.5
Sniper Elite 3: Sniper Elite, Sniper Elite V2, Sniper Elite Nazi Zombie Army 2, Sniper Elite Nazi Zombie Army, Sniper Elite Zombie Army, Sniper Elite Zombie Army 2
Gratuitous Space Battles: Gratuitous Tank Battles
Rise of Nations Extended Edition: Anna - Extended Edition
Dishonored: Dishonored (RU)
Wolfenstein The New Order: Wolfenstein, Wolfenstein The New Order German Edition, Wolfenstein 3D
Epic Battle Fantasy 4: Epic Battle Fantasy 4 - Soundtrack
Metro Last Light: Metro Last Light Redux, Light
Dead Space: Dead Space 2, Dead State
Hotline Miami: Hotline Miami 2 Wrong Number, Hotline Miami 2 Wrong Number Digital Comic
Crypt of the NecroDancer: Crypt of the NecroDancer Extended Soundtrack, Crypt of the NecroDancer Extras
Kairo: Karos
The Binding of Isaac: The Binding of Isaac Rebirth
LEGO The Lord of the Rings: The Lord of the Rings War in the North, The Lord of the Rings Online
Starpoint Gemini 2: Starpoint Gemini
The Vanishing of Ethan Carter: The Vanishing of Ethan Carter Redux
Goat Simulator: Grass Simulator
Mass Effect: Mass Effect 2
Arma 2 Operation Arrowhead: Arma 2, Arma 2 Operation Arrowhead Beta (Obsolete), Operation Z, Arma 3
Sonic Adventure 2 : Sonic Adventure 2 Battle Mode DLC, Sonic Adventure DX
Battlestations Midway: Battlestations Pacific
Mark of the Ninja: Mark of the Ninja Special Edition DLC, Teenage Mutant Ninja Turtles Out of the Shadows
Grow Home: Home, Grow Home Soundtrack DLC
No Time To Explain Remastered: No Time to Explain
The Legend of Heroes Trails in the Sky: The Legend of Heroes Trails in the Sky SC, Legend of Fae, The Legend of Korra, The Legend of Tango
Bleed: They Bleed Pixels
Borderlands 2: Borderlands, Borderlands 2 Headhunter 1 Bloody Harvest, Borderlands 2 Headhunter 2 Wattle Gobbler, Borderlands 2 Headhunter 3 Mercenary Day, Borderlands 2 Headhunter 4 Wedding Day Massacre, Borderlands 2 Headhunter 5 Son of Crawmerax
Race The Sun: Race The WTCC Game, Teddy Floppy Ear - The Race, The Great Art Race, Bone The Great Cow Race, Secret of the Magic Crystals - The Race
Shadowgrounds: Shadowgrounds Survivor
Trine: Trine 2, Trine 3 The Artifacts of Power
Symphony: Blade Symphony, Color Symphony
Freedom Planet: Freedom Planet - Official Soundtrack
Galcon Legends: Galcon 2, GT Legends
INK: INK - Soundtrack + Art
Amnesia The Dark Descent: Descent, Descent 2, Descent 3
Fieldrunners: Fieldrunners 2
KAMI: KAMUI
Lone Survivor The Director's Cut: Sol Survivor
Frozen Synapse: Frozen Synapse Prime
GRID 2: GRID, GRID 2 GTR Racing Pack, GRID Autosport
Call of Juarez Gunslinger: Call of Juarez
Crysis 2 Maximum Edition: Crysis, Crysis 2
Strike Vector: Vector
Lego Harry Potter: LEGO Harry Potter Years 5-7
Outlast: Outlast Whistleblower DLC
Valkyria Chronicles: Valkyria Chronicles Challenge of the Edy Detachment, Valkyria Chronicles Edy's Mission Enter the Edy Detachment, Valkyria Chronicles Hard EX Mode, Valkyria Chronicles Selveria's Mission Behind Her Blue Flame
Spelunky: Spelunx
STAR WARS Knights of the Old Republic II The Sith Lords: Star Wars Knights of the Old Republic, Lords of the Realm II, Lords of the Realm
Phantom Breaker Battle Grounds: Phantom Breaker Battle Grounds - Kurisu Makise + Level 99 Pack
Tom Clancy's Splinter Cell Chaos Theory: Tom Clancy's Splinter Cell, Tom Clancy's Splinter Cell Blacklist, Tom Clancy's Splinter Cell Conviction, Tom Clancy's Splinter Cell Double Agent
The Witcher Enhanced Edition: The Witcher 2 Assassins of Kings Enhanced Edition
Need for Speed Hot Pursuit: Need for Speed SHIFT
The Crew: The Few
Ethan Meteor Hunter: Ethan Meteor Hunter Deluxe Content
Camera Obscura: Camera Obscura Soundtrack
Call of Duty Modern Warfare 2 - Multiplayer: Call of Duty Modern Warfare 2, Call of Duty 2, Call of Duty, Call of Duty Modern Warfare 3 - Multiplayer, Call of Duty Modern Warfare 3, Call of Duty 4 Modern Warfare
PixelJunk Shooter: PixelJunk Shooter Ultimate
Arma 2 British Armed Forces: Arma 2, Arma 3
Battlefield Bad Company 2: Battlefield Bad Company 2 Vietnam, Battlefield 2
Half-Life Deathmatch Source: Half-Life, Half-Life Source, Half-Life 2 Deathmatch, Half-Life 2
Age of Empires III Complete Collection: Empires, Age of Empires Online
Age of Mythology Extended Edition: Anna - Extended Edition
America's Army 3: America's Army Proving Grounds
Arma 2 Private Military Company: Arma 2, Arma 3
Audiosurf: Audiosurf 2
Axis Game Factory's AGFPRO - Drone Kombat FPS Multi-Player DLC: Axis Game Factory's AGFPRO 3.0
Axis Game Factory's AGFPRO - Zombie Survival Pack DLC: Axis Game Factory's AGFPRO 3.0, I, Zombie, Tryst Survival DLC
Beatbuddy Tale of the Guardians: Guardians of Orion
Beat Hazard: Beat Hazard - Shadow Operations Unit
Borderlands DLC Claptraps New Robot Revolution: Borderlands, Borderlands 2, Revolution Ace, Robot Rescue Revolution, Borderlands 2 RU
Borderlands DLC Mad Moxxi's Underdome Riot: Borderlands, Borderlands 2, Borderlands 2 RU
Borderlands DLC The Secret Armory of General Knoxx: Borderlands, Borderlands 2, Borderlands 2 RU
Borderlands DLC The Zombie Island of Dr. Ned: Borderlands, Borderlands 2, Borderlands 2 RU, I, Zombie
Breach & Clear: Breach & Clear Deadline, Breach
Brothers - A Tale of Two Sons: Two Brothers
Castle Crashers: Castle Crashers - Blacksmith Pack, Castle Crashers - Pink Knight Pack, Castle
Child of Light: Light
Cities Skylines: Cities XL
Command and Conquer 3 Kane's Wrath: Command HQ, Command and Conquer Red Alert 3
Command and Conquer 3 Tiberium Wars: Command HQ, Command and Conquer Red Alert 3
Command and Conquer Red Alert 3 - Uprising: Command and Conquer Red Alert 3, Command HQ
Darksiders: Darksiders II, Darksiders II Deathinitive Edition, Darksiders II Soundtrack, Darksiders Soundtrack
DARK SOULS II Scholar of the First Sin: DARK SOULS II, DARK
Deadlight: Deadlight Original Soundtrack, Daylight
Democracy 3: Democracy 3 Clones and Drones, Democracy 3 Extremism, Democracy 3 Extremism Linux, Democracy 3 Extremism Mac, Democracy 3 Social Engineering, Democracy 3 Social Engineering Linux
Deus Ex Game of the Year Edition: Fallout 3 - Game of the Year Edition, Warhammer 40,000 Dawn of War - Game of the Year Edition, Unreal Tournament Game of the Year Edition
Deus Ex The Fall: The Fall, Deus Ex Human Revolution - The Missing Link
Devil May Cry 4: Devil May Cry 4 Special Edition, DmC Devil May Cry, Devil May Cry 3 Special Edition
Door Kickers: Door Kickers Soundtrack
Fallen Enchantress Legendary Heroes: Legendary, Fallen Enchantress, Fallen Enchantress Legendary Heroes Map Pack, Fallen Enchantress Legendary Heroes - The Dead World, Fallen Enchantress Legendary Heroes Leader Pack, Fallen Enchantress Legendary Heroes Loot Pack
Finding Teddy: Finding Teddy Soundtrack
Galcon Fusion: Galcon 2
GameGuru: GameGuru - Buildings Pack
Giana Sisters Twisted Dreams: Giana Sisters Twisted Dreams - Rise of the Owlverlord
Gone Home: Home
Gotham City Impostors Free To Play: Gotham City Impostors, Free to Play
Gothic: Gothic 3, Gothic II Gold Edition, Gothic 3 Forsaken Gods Enhanced Edition
Guacamelee! Gold Edition: Guacamelee! Super Turbo Championship Edition, Arma Gold Edition
Guardians of Middle-earth: Guardians of Orion
Hero Siege: Hero Siege - The Karp of Doom (Digital Collector's Edition), Hero Siege - The Depths of Hell (Collector's Edition), Hero Siege - The Depths of Hell, Hero Siege - The Karp of Doom
How to Survive: How To Survive Third Person
Kingdoms of Amalur Reckoning: Kingdoms, Kingdoms CCG
Lara Croft and the Guardian of Light: Light
Legends of Persia: GT Legends, Legend of Mysteria, Legends of Pegasus
LEGO Batman The Videogame: LEGO Batman 2, The LEGO Movie - Videogame
LISA: LISA the Joyful, LISA Soundtrack + Art Collection
Max Payne 3: Max Payne, Max Payne 3 Season Pass, Max Payne 2 The Fall of Max Payne
Mechanic Escape: Escape
Medal of Honor(TM) Multiplayer: SiN Multiplayer
METAL SLUG 3: METAL SLUG X, METAL SLUG DEFENSE, METAL SLUG DEFENSE - Ptolemaic Army Pack Vol.1
Mortal Kombat Kollection: Mortal Kombat X
Need for Speed Undercover: Need for Speed SHIFT
Never Alone Original Soundtrack: FORCED Original Soundtrack, HuniePop Original Soundtrack, Axiom Verge Original Soundtrack, Original War
PAYDAY 2: PAYDAY The Heist, PAYDAY Wolf Pack, PAYDAY The Web Series - Episode 1, PAYDAY The Heist Game Soundtrack
Penny Arcade's On the Rain-Slick Precipice of Darkness 3: Penny Arcade's On the Rain-Slick Precipice of Darkness 4
POSTAL 2: POSTAL, POSTAL 2 Paradise Lost
Red Faction Armageddon: Red Faction, Red Faction Armageddon Soundtrack, Red Faction II
Red Faction Guerrilla Steam Edition: Red Faction, Red Faction II, TRIP Steam Edition
resident evil 4 / biohazard 4: Resident Evil 5 / Biohazard 5, Resident Evil 6 / Biohazard 6
Resident Evil Revelations / Biohazard Revelations: Resident Evil Revelations 2 / Biohazard Revelations 2, Resident Evil 5 / Biohazard 5, Resident Evil 6 / Biohazard 6, Revelations 2012
Rochard: Rochard - Hard Times
RollerCoaster Tycoon 3 Platinum!: RollerCoaster Tycoon, RollerCoaster Tycoon Deluxe
RPG Maker Luna Engine: RPG Maker XP, RPG Maker MV
RPG Maker VX Ace: RPG Maker XP, RPG Maker MV
Saints Row Gat out of Hell: Saints Row 2, Saints Row IV
Scribblenauts Unlimited: Scribblenauts Unmasked
Shadowrun Dragonfall - Director's Cut: Shadowrun Dragonfall
Shadow Warrior: Viscera Cleanup Detail Shadow Warrior, Shadow Warrior Classic (1997), Shadow Warrior Classic Redux, Shadow Warrior (Classic)
Shank: Shank 2
Sins of a Solar Empire Rebellion: Sins of a Solar Empire Rebellion Soundtrack, Sins of a Solar Empire Rebellion - Stellar Phenomena DLC, Sins of a Solar Empire Rebellion Forbidden Worlds, Sins of a Solar Empire Trinity, Solar 2
Spiral Knights: Spiral Knights Preview
Star Wars - Jedi Knight Mysteries of the Sith: Star Wars Jedi Knight Jedi Academy, Star Wars - Jedi Knight II Jedi Outcast
Star Wars Dark Forces: Star Wars Jedi Knight Dark Forces II
Star Wars The Force Unleashed II: Star Wars The Force Unleashed Ultimate Sith Edition
Star Wars Republic Commando: Star Wars Knights of the Old Republic, Star Wars The Clone Wars Republic Heroes
State of Decay: State of Decay - Breakdown, State of Decay - Lifeline, State of Decay Year-One
Syberia: Syberia 2
The Cat Lady: The Lady
The Incredible Adventures of Van Helsing II: The Incredible Adventures of Van Helsing, The Incredible Adventures of Van Helsing III, The Incredible Adventures of Van Helsing Thaumaturge, The Incredible Adventures of Van Helsing Final Cut, The Adventures of Tree
The Witcher 3 Wild Hunt: The Witcher 3 Wild Hunt - New Finisher Animations, The Witcher 3 Wild Hunt - Expansion Pass
Thief: Thief Gold, The Raven - Legacy of a Master Thief, Thief Deadly Shadows, Thief 2, Fairy Tale Mysteries The Puppet Thief Collector's Edition, Thief - Ghost
This War of Mine: This War of Mine - War Child Charity DLC
Titan Quest: Titan Quest Immortal Throne
Torchlight: Torchlight II
Total War SHOGUN 2: Total War SHOGUN 2 - Fall of the Samurai, SHOGUN Total War - Gold Edition, Total War Battles SHOGUN
Transistor: Transistor Soundtrack
Unturned: Unturned - Permanent Gold Upgrade
Ys Origin: F.E.A.R. 2 Project Origin, Mortal Kombat Legacy II - Ep. 3 Kenshi's Origin, Dracula Origin
Strife: Strife Veteran Edition
Call of Duty Black Ops - Multiplayer: Call of Duty Black Ops, Call of Duty Black Ops II - Multiplayer, Call of Duty Black Ops - Multiplayer OSX, Call of Duty, Call of Duty Black Ops II, Call of Duty Black Ops - OSX
Dungeon Defenders: Dungeon Defenders II, Dungeon Defenders Eternity
Day of Defeat Source: Day of Defeat
ArcheAge: ArcheAge Silver Founders Pack, ArcheAge Archeum Founders Pack, ArcheAge Gold Founders Pack
Empire Total War: Rome Total War
Alien Swarm: Swarm Arena
TERA: TERA Accessorize Pack, TERA Explorer's Pack, TERA Starter Pack, TERA Steam-Powered Pack
Counter-Strike Nexon Zombies: Counter-Strike, Counter-Strike Nexon Zombies - Starter Pack, Counter-Strike Source
Everlasting Summer: Everlasting Summer DLC One pioneer's story
Dragon Nest Europe: Dragon Nest
Loadout: Loadout Campaign Beta, Loadout Steam Launch Starter Pack
Neverwinter: Neverwinter Nights 2 Platinum
RIFT: RIFT Infusion Edition, RIFT Typhoon Edition
Warframe: Warface
theHunter: theHunter Primal
Mafia II: Mafia
Revenge of the Titans: Galactic Civilizations III - Revenge of the Snathi DLC
Europa Universalis III: Europa Universalis III Divine Wind, Europa Universalis III Heir to the Throne, Europa Universalis IV, Europa Universalis IV Conquest of Paradise, Europa Universalis IV American Dream DLC, Europa Universalis IV Conquistadors Unit pack 
Arma Cold War Assault: Arma 2, Arma 3
Batman Arkham Origins - New Millennium Skins Pack: Batman Arkham Origins, Batman Arkham City, Millennium - A New Hope, Batman Arkham Origins - Infinite Earths Skins Pack, Batman Arkham Origins - Initiation
Cortex Command: Command HQ
Deadbreed: Deadbreed  Undertaker Beta Pack
Eets Munchies: Eets
Enclave: Siege of Turtle Enclave
GTR Evolution: BiT Evolution, Evolution RTS, Hacker Evolution, Trials Evolution Gold Edition, ACE - Arena Cyber Evolution, Hacker Evolution - Untold
RACE 07: RACE 07 - Formula RaceRoom Add-On
Woodle Tree Adventures: The Adventures of Tree
Tom Clancy's Ghost Recon Phantoms - NA: Tom Clancy's Ghost Recon Phantoms - NA Recon Starter Pack, Tom Clancy's Ghost Recon Phantoms - NA Assault Starter Pack, Tom Clancy's Ghost Recon Phantoms - NA Looks and Power (Assault), Tom Clancy's Ghost Recon Phantoms - NA Looks and Power (Recon), Tom Clancy's Ghost Recon Phantoms - NA Looks and Power (Support), Tom Clancy's Ghost Recon Phantoms - NA Substance with Style pack (Assault)
APB Reloaded: Worms Reloaded, Alien Shooter 2 Reloaded, StuntMANIA Reloaded, Mutant Storm Reloaded
Counter-Strike Condition Zero: Counter-Strike, Counter-Strike Condition Zero Deleted Scenes, Counter-Strike Source
Mount & Blade Warband: Mount & Blade Warband - Napoleonic Wars, Mount & Blade Warband - Viking Conquest Reforged Edition, Mount & Blade
Tom Clancy's Ghost Recon Phantoms - EU: Tom Clancy's Ghost Recon Phantoms - EU Support Starter Pack, Tom Clancy's Ghost Recon Phantoms - EU The Thrill of the Surprise, Tom Clancy's Ghost Recon Phantoms - EU 100% XP/AC Boost - 30 days, Tom Clancy's Ghost Recon Phantoms - EU Assault Starter Pack, Tom Clancy's Ghost Recon Phantoms - EU Looks and Power (Assault), Tom Clancy's Ghost Recon Phantoms - EU Looks and Power (Recon)
My Lands: My Lands Miners Luck - Starter DLC Pack
Brick-Force: Brick-Force (US)
Half-Life Blue Shift: Half-Life, Half-Life 2
Half-Life Opposing Force: Half-Life, Half-Life 2
Project CARS: Project CARS - Modified Car Pack , Project CARS - Audi Ruapuna Speedway Expansion Pack, Project CARS - Old Vs New Car Pack, Project AURA
Defense Grid The Awakening: Defense Grid 2
Universe Sandbox: Universe Sandbox 
Toki Tori: Toki Tori 2+
The Wonderful End of the World: Fate of the World, World of Goo, World of Zoo
Costume Quest: Costume Quest 2, Comedy Quest
RUSH: N.P.P.D. RUSH - The milk of Ultra violet, C-RUSH
Return to Mysterious Island 2: Return to Mysterious Island
Defense Grid 2 A Matter of Endurance: Defense Grid 2
Back to the Future Ep 2 - Get Tannen!: Bard to the Future, Back to the Future Ep 5 - OUTATIME
The Ball: The Fall
Back to the Future Ep 1 - It's About Time: Bard to the Future, Back to the Future Ep 5 - OUTATIME
Back to the Future Ep 4 - Double Visions: Bard to the Future, Back to the Future Ep 5 - OUTATIME
Back to the Future Ep 3 - Citizen Brown: Bard to the Future, Back to the Future Ep 5 - OUTATIME
BIT.TRIP BEAT: BIT.TRIP FATE
Atom Zombie Smasher : I, Zombie
Ticket to Ride: Ticket to Ride - Europe, Ticket to Ride - USA 1910, Ticket to Ride - Legendary Asia, Ticket to Ride - Switzerland
Penumbra Overture: Overture
Pixel Puzzles Japan: Pixel Puzzles UndeadZ, Pixel Puzzles 2 Anime, Pixel Puzzles 2 Birds
Dead Bits: Dead Bits (Soundtrack)
Defense Grid Containment DLC: Defense Grid 2
Defense Grid Resurgence Map Pack 1: Defense Grid Resurgence Map Pack 2 , Defense Grid Resurgence Map Pack 3, Defense Grid Resurgence Map Pack 4, Defense Grid 2
Five Nights at Freddy's 2: Five Nights at Freddy's, Five Nights at Freddy's 3, Five Nights at Freddy's 4
Oddworld Abe's Oddysee: Oddworld Munch's Oddysee, Oddworld Abe's Exoddus
Sam & Max 106 Bright Side of the Moon: To the Moon
Steel Storm Burning Retribution: Storm
Bookworm Adventures Deluxe: BookWorm Adventures Volume 2
Hidden Object Bundle 4 in 1: Hidden Object Bundle 5 in 1
FlatOut Ultimate Carnage: FlatOut, FlatOut 2
Ghost Master: Post Master 
Bejeweled 3: Bejeweled Deluxe, Bejeweled 2 Deluxe, Bejeweled Twist
The Book of Unwritten Tales: The Book of Unwritten Tales The Critter Chronicles, The Book of Unwritten Tales Extras, The Book of Unwritten Tales 2
The Movies: The Movies Stunts and Effects
The Walking Dead: The Walking Dead Season Two, Pinball FX2 - The Walking Dead Table, The Escapists The Walking Dead, The Walking Dead Survival Instinct
The Testament of Sherlock Holmes: Sherlock Holmes and The Hound of The Baskervilles
Indigo Prophecy: Fahrenheit Indigo Prophecy Remastered
Crazy Machines 2: Crazy Machines 2 - Jewel Digger DLC, Crazy Machines 2 Fluid Add-On, Crazy Machines, Crazy Machines Elements, Crazy Machines 1.5 Inventors Training Camp, Crazy Machines 1.5 New from the Lab
The Secret of Monkey Island Special Edition: Monkey Island 2 Special Edition
Deponia The Complete Journey: Deponia
Tales of Monkey Island Chapter 1 - Launch of the Screaming Narwhal: Tales of Monkey Island Chapter 3 - Lair of the Leviathan , Tales of Monkey Island Chapter 5 - Rise of the Pirate God
Worms Clan Wars: Worms
4 Elements: Crazy Machines Elements, Dungeon of Elements, Elements Soul of Fire, The Tower Of Elements
Grim Legends The Forsaken Bride: GT Legends
Nightmares from the Deep 2 The Siren`s Call: Nightmares from the Deep The Cursed Heart
The Jackbox Party Pack: The Jackbox Party Pack 2
Singularity: Ashes of the Singularity
The Maw: The Maw Brute Force, The Maw River Redirect, The Maw Speeder Lane
Poker Night at the Inventory: Poker Night 2
Puzzle Agent: Puzzle Agent 2
Alchemy Mysteries Prague Legends: GT Legends
Hector Ep 1: Hector Ep 2, Hector Ep 3
Penumbra Requiem: Requiem
The Cave: Nancy Drew The Creature of Kapu Cave
YOU DON'T KNOW JACK Vol. 1 XL: YOU DON'T KNOW JACK, YOU DON'T KNOW JACK Vol. 2, YOU DON'T KNOW JACK Vol. 3, YOU DON'T KNOW JACK Vol. 4 The Ride, YOU DON'T KNOW JACK MOVIES, YOU DON'T KNOW JACK SPORTS
Zeno Clash: Zeno Clash 2
FORCED: FORCED Original Soundtrack
The Longest Journey: Dreamfall The Longest Journey
The Path - Prologue: The Path
Prince of Persia: Prince of Persia The Forgotten Sands, Prince of Persia The Sands of Time, Prince of Persia The Two Thrones, Prince of Persia Warrior Within
Afterfall InSanity Extended Edition: Afterfall InSanity - Dirty Arena Edition, Anna - Extended Edition
Aliens vs. Predator: Aliens versus Predator Classic 2000
Always Sometimes Monsters: Always Sometimes Monsters Demo, Always Sometimes Monsters - Soundtrack
Anomaly Korea: Anomaly 2
Chaser: Caster
Damned: Mordheim City of the Damned
Depth Hunter 2 Deep Dive: Depth
Dogfight 1942: Dogfight 1942 Fire over Africa, Dogfight 1942 Russia under Siege
Duke Nukem Forever: Duke Nukem, Duke Nukem Forever , Duke Nukem 2, Duke Nukem 3D
Forge: Hunted The Demon's Forge, Wizardry 6 Bane of the Cosmic Forge
Hard Reset: Hard Reset Exile DLC
Legend of Grimrock: Legend of Grimrock 2, Legend of Fae
Magicka Wizard's Survival Kit: Magicka, Magicka 2
Maia: Mafia
Men of War Condemned Heroes: Men of War
Papo & Yo: Papo & Yo Soundtrack
Pressure: Pressured
Red Orchestra 2 Heroes of Stalingrad - Single Player: Red Orchestra Beta
Rising Storm/Red Orchestra 2 Multiplayer: SiN Multiplayer
Sniper Ghost Warrior: Sniper Ghost Warrior 2, Sniper Ghost Warrior 2 Multiplayer Expansion Pack, Sniper Ghost Warrior 2 World Hunter Pack
Still Life: Still Life 2
Supreme Commander 2: Supreme Commander, Supreme Commander 2 - Infinite War Battle Pack One, Supreme Commander Forged Alliance
The Basement Collection: Basement
The Dream Machine: The Dream Machine Chapter 3, The Dream Machine Chapter 4, The Dream Machine Chapter 5, Dream
The Whispered World: The Whispered World Special Edition
Tomb Raider Underworld: Tomb Raider, Tomb Raider I, Tomb Raider II
Tomb Raider III Adventures of Lara Croft: Tomb Raider, Tomb Raider I, Tomb Raider II
Toy Soldiers: Toy Soldiers War Chest, Toy Soldiers Complete, Swords and Soldiers HD
Wasteland Angel: Wasteland 2
YOU DON'T KNOW JACK HEADRUSH: YOU DON'T KNOW JACK, YOU DON'T KNOW JACK MOVIES, YOU DON'T KNOW JACK SPORTS, YOU DON'T KNOW JACK Vol. 2, YOU DON'T KNOW JACK Vol. 3, YOU DON'T KNOW JACK Vol. 1 XL
YOU DON'T KNOW JACK TELEVISION: YOU DON'T KNOW JACK, YOU DON'T KNOW JACK MOVIES, YOU DON'T KNOW JACK SPORTS, YOU DON'T KNOW JACK Vol. 2, YOU DON'T KNOW JACK Vol. 3, YOU DON'T KNOW JACK HEADRUSH
The Sims(TM) 3: The Sims(TM) Medieval
H1Z1: H1Z1 Test Server
Commandos 3 Destination Berlin: Destination Sol
Clans: The Clans - Saga of the Twins, Hard Truck Apocalypse Rise Of Clans / Ex Machina Meridian 113
Labyronia RPG: Labyronia RPG 2
Aftermath: Project Aftermath, UFO Aftermath
Happy Wars: Happy Wars - Evil Warrior Set
Aura Kingdom: Kingdom, Aura Kingdom - Winter Gift
World of Guns Gun Disassembly: World of Goo, World of Zoo
Quake Live: Quake, Quake 4
Soccer Manager 2016: Soccer Manager 2015, Worldwide Soccer Manager 2009
Ragnarok: Ragnarok Online 2, Heroine's Quest The Herald of Ragnarok, Ragnarok Online - Free to Play - European Version
Tribes Ascend: Tribes Ascend - Steam Starter Pack
Black Fire: Fire
Kung Fury: Kung Fury Street Rage
Mortal Kombat Komplete Edition: Mortal Kombat X
Call of Duty Advanced Warfare: Call of Duty Advanced Warfare - Multiplayer, Call of Duty, Call of Duty 2, Call of Duty Modern Warfare 2 - Multiplayer, Call of Duty Modern Warfare 2, Call of Duty Modern Warfare 3 - Multiplayer
Euro Truck Simulator 2: Euro Truck Simulator 2 - Going East!, Euro Truck Simulator 2 - Ice Cold Paint Jobs Pack, Euro Truck Simulator, Scania Truck Driving Simulator
Aion: Aion Collectors Edition
Arma 3 Zeus: Arma 3, Arma 2
Endless Sky: Endless Sky - High DPI
Amazing World: Amazing Adventures Around the World
Pirates of Black Cove Gold: Pirates of Black Cove
Red Orchestra Ostfront 41-45: Red Orchestra Beta
Trove: Trove Power Pack, Trove Arcanium Expedition Pack
R.U.S.E: R.U.S.E.
Stronghold 3: Stronghold 2, Stronghold HD, Stronghold Kingdoms, Stronghold Crusader Extreme HD, Stronghold Crusader HD, Stronghold Legends
Anomaly Warzone Earth: Anomaly Warzone Earth Mobile Campaign, Anomaly 2
Starbound: Starbound - Unstable, Starbound - Soundtrack, Starbound Free Avatars
Marvel Puzzle Quest: Puzzle Quest, Puzzle Quest 2
NARUTO SHIPPUDEN Ultimate Ninja STORM 3 Full Burst: NARUTO SHIPPUDEN Ultimate Ninja STORM Revolution
Don't Starve: Don't Starve Together Beta, Don't Starve Reign of Giants, Don't Starve Shipwrecked
Command and Conquer 4 Tiberian Twilight: Command HQ
Transformers Fall of Cybertron: Transformers War for Cybertron
Might & Magic Heroes VI: Might & Magic Heroes VII , Heroes of Might & Magic III - HD Edition, Heroes of Might & Magic V, Might & Magic Clash of Heroes, Might & Magic Heroes Online, Heroes of Might & Magic V Tribes of the East
Warhammer 40,000 Dawn of War II: Warhammer 40,000 Dawn of War II  Retribution, Warhammer 40,000 Dawn of War II - Chaos Rising, Warhammer 40,000 Dawn of War - Game of the Year Edition, Warhammer 40,000 Dawn of War  Dark Crusade, Warhammer 40,000 Dawn of War  Winter Assault, Warhammer 40,000 Dawn of War  Soulstorm
Dungeon Siege 2: Dungeon Siege, Dungeon Siege III
Trapped Dead: Trapped Dead Lockdown
Tom Clancy's H.A.W.X. 2: Tom Clancy's H.A.W.X.
Alpha Protocol: Protocol
Crysis Warhead: Crysis, Crysis 2, Crysis Wars
Grand Theft Auto Vice City: Grand Theft Auto, Grand Theft Auto V, Grand Theft Auto 2, Grand Theft Auto IV, Grand Theft Auto Episodes from Liberty City, Grand Theft Auto III
Overlord: Overlord Raising Hell, Overlord II, Overlord Fellowship of Evil, Undead Overlord
Tom Clancy's Ghost Recon Advanced Warfighter 2: Tom Clancy's Ghost Recon Advanced Warfighter, Tom Clancy's Ghost Recon
Two Worlds Epic Edition: Two Worlds II
Two Worlds II Castle Defense: Two Worlds II, Castle
Call of Duty Black Ops II - Zombies: Call of Duty Black Ops, Call of Duty Black Ops II, Call of Duty, Call of Duty Black Ops - OSX, Call of Duty 2, Call of Duty Black Ops III
Medieval II Total War: Medieval II Total War Kingdoms
Defiance: Legacy of Kain Defiance, Defiance Arktech Revolution
HAWKEN: HAWKEN - Mercenary Bundle
Full Spectrum Warrior: Full Spectrum Warrior Ten Hammers
Men of War Assault Squad 2: Men of War, Men of War Assault Squad, Squad
Omerta - City of Gangsters: Omerta - City of Gangsters The Bulgarian Colossus
A Game of Thrones - Genesis: Game of Thrones , Game of Thrones - A Telltale Games Series
The Ship Single Player: The Ship
The Ship Tutorial: The Ship
COH2 - The Western Front Armies Oberkommando West: COH2 - The Western Front Armies US Forces
Company of Heroes 2 - Ardennes Assault: Company of Heroes, Company of Heroes 2
Magicka Holiday Spirit Item Pack : Magicka, Magicka 2
Men of War Red Tide: Men of War
Men of War Vietnam: Men of War
Section 8: Section 8 Prejudice
Risen 2 - Dark Waters: Risen
Primal Carnage Extinction: Primal Carnage
The Forest: The Forest of Doom
Knights of Pen and Paper +1: Knights of Pen and Paper 2
King's Quest: King's Quest Collection
Star Conflict: Metro Conflict
Wind of Luck Arena: Wind of Luck Arena - Mediterranean Captain pack
Chaos Heroes Online: Might & Magic Heroes Online, Heroes and Titans Online
Football Manager 2013: Football Manager 2011, Football Manager 2012, Football Manager 2015, Football Manager 2014, Football Manager 2016, Football Manager 2010
Arma 2 Free: Arma 2, Arma 3
Bloodline Champions: Champions Online
Dungeonland: Dungeonland - All access pass
Dungeon Party: Dungeon Hearts
EverQuest Free-to-Play: EverQuest II, AION Free-to-Play
Fiesta Online: Fiesta Online NA
Frontline Tactics: Frontline Tactics - Close Quater Combat Soldier, Frontline Tactics - Medic Soldier Pack, Frontline Tactics - Sniper, Frontline Tactics - Desert Camouflage, Frontline Tactics - Golden Guns, Frontline Tactics - Ninja Camouflage
Magic The Gathering  Tactics: Magic The Gathering - Duels of the Planeswalkers, Magic The Gathering - Duels of the Planeswalkers 2013, Magic The Gathering  Duels of the Planeswalkers 2012
March of War: War of Beach, March of the Eagles
Reversion - The Escape: Escape, Reversion - The Meeting
Star Trek Online: Star Trek
Super Monday Night Combat: Monday Night Combat
The Forgotten Ones: Age of Empires II HD The Forgotten, Prince of Persia The Forgotten Sands, 8-Bit Adventures The Forgotten Journey Remastered Edition
Uncharted Waters Online: Uncharted Waters Online Gran Atlas
World of Battles: World of Goo, World of Zoo
Mount & Blade With Fire and Sword: Mount & Blade, Fire, Run and Fire
LEGO Batman 3 Beyond Gotham: LEGO Batman 2
Lego Star Wars 3 The Clone Wars: Lego Star Wars Saga, Star Wars The Clone Wars Republic Heroes
Castlevania Lords of Shadow - Ultimate Edition: Castlevania Lords of Shadow 2
Magic 2014 : Magic 2015
SONIC THE HEDGEHOG 4 Episode II: SONIC THE HEDGEHOG 4 Episode I
Mortal Kombat Legacy - Ep. 3 Johnny Cage: Mortal Kombat Legacy II - Ep. 6 Johnny Cage, Mortal Kombat X, Mortal Kombat Legacy - Ep. 6 Raiden, Mortal Kombat Legacy II - Ep. 3 Kenshi's Origin
Mortal Kombat Legacy - Ep. 4 Kitana & Mileena (Part 1): Mortal Kombat Legacy - Ep. 5 Kitana & Mileena (Part 2), Mortal Kombat X, Mortal Kombat Legacy II - Ep. 5 Kitana and Mileena, Mortal Kombat Legacy - Ep. 6 Raiden
Mortal Kombat Legacy - Ep. 7 Scorpion and Sub-Zero (Part 1): Mortal Kombat Legacy II - Ep. 7 Scorpion and Sub-Zero (Part 1), Mortal Kombat Legacy - Ep. 8 Scorpion and Sub-Zero (Part 2), Mortal Kombat Legacy II - Ep. 8 Scorpion and Sub-Zero (Part 2), Mortal Kombat X, Mortal Kombat Legacy - Ep. 6 Raiden
Mortal Kombat Legacy - Ep. 9 Cyrax & Sektor: Mortal Kombat X, Mortal Kombat Legacy - Ep. 6 Raiden, Mortal Kombat Legacy II - Ep. 9 Liu Kang
Galactic Civilizations III: Galactic Civilizations III Soundtrack, Galactic Civilizations III - Map Pack DLC, Galactic Civilizations III - Mega Events DLC, Galactic Civilizations III - Precursor Worlds DLC, Galactic Civilizations III - Revenge of the Snathi DLC, Galactic Civilizations III - Ship Designer's Toolbox DLC
Total War ATTILA: Total War ATTILA - Age of Charlemagne Campaign Pack
Franchise Hockey Manager 2014: Franchise Hockey Manager 2
Dark Messiah of Might & Magic Single Player: Dark Messiah of Might & Magic Multi-Player
Crusader Kings II: Crusader Kings II Hymns of Abraham, Crusader Kings II Military Orders Unit Pack, Crusader Kings II Sons of Abraham, Crusader Kings II Warriors of Faith Unit Pack, Crusader Kings Complete
Prey: Wings of Prey, Beasts of Prey
Wasteland 2 Director's Cut: Wasteland 2
Planetary Annihilation: Planetary Annihilation TITANS, Planetary Annihilation - Digital Deluxe Bundle, Planetary Annihilation - Original Soundtrack, Total Annihilation
SiN Episodes Emergence: SiN
3DMark: 3DMark API Overhead feature test, 3DMark Cloud Gate benchmark, 3DMark Fire Strike benchmark, 3DMark Ice Storm benchmark, 3DMark Sky Diver benchmark, 3DMark Vantage
Space Empires IV Deluxe: Empires, Space Empires V
Out of the Park Baseball 15: Out of the Park Baseball 14, Out of the Park Baseball 16
DOOM 3 Resurrection of Evil: DOOM 3
Wasteland 1 - The Original Classic: Wasteland 2, Original War
Farming Simulator 15: Farming Simulator 15 - ITRunner, Farming Simulator 2011, Farming Simulator 2013, Farming Simulator 2013 - Modding Tutorials, Agricultural Simulator Historical Farming
Sid Meier's Civilization Beyond Earth: Sid Meier's Civilization Beyond Earth - Rising Tide, Sid Meier's Civilization V, Sid Meier's Civilization IV, Sid Meier's Civilization IV Beyond the Sword, Sid Meier's Civilization IV Warlords
Arma 3 Helicopters: Arma 3, Arma 2
Arma 3 Karts: Arma 3, Arma 2
Arma 3 Marksmen: Arma 3, Arma 2
Magicka Wizard Wars: Magicka, Magicka 2
Anno 1404 Venice: Anno 1404, Venice
The Escapists: The Escapists The Walking Dead
Dynasty Warriors 8 - Empires: Empires
King Arthur II - The Role-playing Wargame: King Arthur - The Role-playing Wargame, King Arthur The Druids, King Arthur The Saxons
Space Hulk: Space Hulk Ascension, Space Hack
Call of Duty Ghosts: Call of Duty Ghosts - Multiplayer, Call of Duty, Call of Duty 2
Horizon: Shattered Horizon, Shattered Horizon Arconauts, Lost Horizon, Super Chain Crusher Horizon, Horizon Shift
Lost Planet Extreme Condition: Lost Planet Extreme Condition - Colonies Edition, Lost Planet 3, Lost Planet 2
Warhammer 40,000 Storm of Vengeance Deathwing Terminator: Warhammer 40,000 Storm of Vengeance, Storm, Warhammer 40,000 Storm of Vengeance Bad Moon Clan
Jagged Alliance - Back in Action: Jagged Alliance Gold
Blood Bowl Legendary Edition: Legendary, Blood Bowl 2, Blood Bowl Chaos Edition
Cities XL Platinum: Cities XL
Serious Sam HD The Second Encounter: Serious Sam HD The Second Encounter Player Models, Serious Sam Classic The Second Encounter, Serious Sam 2, Serious Sam HD The First Encounter, Serious Sam The Random Encounter, Serious Sam Classic The First Encounter
War of the Roses: War of the Roses Kingmaker, War of the Roses Balance Beta, Samantha Swift and the Hidden Roses of Athena
Haunted Memories: Haunted
Yet Another Zombie Defense: I, Zombie
Blood of Old: Wolfenstein The Old Blood , Wolfenstein The Old Blood German Edition, Blood Omen 2 Legacy of Kain, Call of Juarez Bound in Blood, Blood of the Werewolf, Foreign Legion Buckets of Blood
DARK SOULS II - Season Pass: DARK SOULS II, DARK, RIDE Season Pass
DARK SOULS II Crown of the Old Iron King: DARK SOULS II, DARK
Tom Clancy's Rainbow Six 3 Gold Edition: Tom Clancy's Rainbow Six Siege, Tom Clancy's Rainbow Six Vegas, Tom Clancy's Rainbow Six Vegas 2, Tom Clancy's Rainbow Six Lockdown, Arma Gold Edition, Tom Clancy's Rainbow Six 3 Athena Sword
Rome Total War - Alexander: Rome Total War
F1 2012: F1 2014, F1 2013, F1 2010, F1 2015, F1 2011
Urizen Shadows of the Cold: Shadows of War, Time of Shadows
Shoot Many Robots: Shoot Many Robots Arena Kings
Borderlands The Pre-Sequel: Borderlands, Borderlands 2, Borderlands 2 RU
Elite Dangerous: Elite Dangerous Horizons
StarDrive 2: StarDrive
Total War Battles KINGDOM: Total War Battles SHOGUN
Lords of the Black Sun: Lords of the Realm
Football Manager 2009: Football Manager 2010, Football Manager 2013, Football Manager 2011, Football Manager 2012, Football Manager 2015, Football Manager 2014
Driving School Simulator: Scania Truck Driving Simulator
Zombie Panic Source: I, Zombie
EverQuest Secrets of Faydwer: EverQuest II
EverQuest Seeds of Destruction: EverQuest II
Road Redemption: Painkiller Redemption
Styx Master of Shadows: Shadows of War, Time of Shadows
The Evil Within: Jack Keane 2 - The Fire Within
Nexuiz: Nexuiz Beta, Nexuiz STUPID Mode
War Operations: Beat Hazard - Shadow Operations Unit, Tank Operations European Campaign, Arma Combat Operations, Operation Z
The Guild II: The Guild II - Pirates of the European Seas, The Guild II Renaissance, The Guild Gold Edition
Carpe Diem: Carpe Diem - Extra Package
Worms Revolution: Worms, Revolution Ace
Rayman Legends: GT Legends
Guild Wars: Guild Wars Trilogy, Guild Wars Nightfall, Guild Wars Game of the Year
Evolve: Evolve - Behemoth, Evolve - Gorgon
Legacy of Kain Soul Reaver: Legacy of Kain Soul Reaver 2
Worms Armageddon: Worms
Worms Blast: Worms
Worms Crazy Golf: Worms
Worms Pinball: Worms
Worms Ultimate Mayhem: Worms
Rabbit Hole 3D Steam Edition: TRIP Steam Edition
Assassins Creed Unity: Assassins Creed Chronicles China, Assassin's Creed, Assassin's Creed Syndicate, Assassin's Creed II
FATE The Traitor Soul: FATE
Serious Sam Classics Revolution: Serious Sam 2, Revolution Ace
Serious Sam Double D XXL: Serious Sam 2
Microsoft Flight Simulator X Steam Edition: Microsoft Flight, TRIP Steam Edition, Island Flight Simulator
Villagers and Heroes: Villagers and Heroes Hero of Stormhold Pack
Duke Nukem 3D Megaton Edition: Duke Nukem, Duke Nukem 3D, Duke Nukem 2
Dungeons of Dredmor: Dungeons 2
Fight The Dragon: Dragon The Game
Painkiller Hell & Damnation: Painkiller Hell & Damnation Beta, Painkiller Hell & Damnation - The Clock Strikes Meat Night, Damnation
Space Rangers HD A War Apart: Space Rangers
Stellar 2D: Sins of a Solar Empire Rebellion - Stellar Phenomena DLC, Stellar Impact
Warlock - Master of the Arcane: Warlock - Master of the Arcane Powerful Lords
Strike Suit Zero: Strike Suit Zero Director's Cut, Strike Suit Infinity
Trainz Simulator 12: Train Simulator
Eufloria: Eufloria HD, Eufloria HD Original Soundtrack
12 Labours of Hercules II The Cretan Bull: 12 Labours of Hercules
ArcaniA: ArcaniA Fall of Setarrif
Deadly Profits: Deadly 30
The Darkness II: Tomb Raider (VI) The Angel of Darkness, Castle In The Darkness, Necronomicon The Dawning of Darkness
The Hat Man Shadow Ward: Shadow Man
The Political Machine: The Political Machine 2016
World Basketball Manager 2010: World Basketball Tycoon
Zombie Driver: Zombie Driver HD, Zombie Driver HD Apocalypse Pack, Zombie Driver Summer of Slaughter DLC, Zombie Grinder, I, Zombie
Zombie Zoeds: I, Zombie
NBA 2K15: NBA 2K16, NBA 2K14, NBA 2K13, NBA 2K10, NBA 2K11, NBA 2K12
Prime World: Prime World Defenders
DYNASTY WARRIORS 8 Xtreme Legends Complete Edition: GT Legends, DiRT 3 Complete Edition
Agarest Generations of War: Agarest Generations of War Premium Edition Upgrade, Agarest Generations of War 2
Hyperdimension Neptunia Re;Birth1: Hyperdimension Neptunia Re;Birth2 Sisters Generation, Hyperdimension Neptunia Re;Birth3 V Generation
Resident Evil Operation Raccoon City: Operation Z
Sacred 2 Gold: Sacred Gold, Disciples Sacred Lands Gold, Sacred 3
Double Dragon Neon: Double Dragon Trilogy
FINAL FANTASY TYPE-0 HD: FINAL FANTASY V, FINAL FANTASY XI, FINAL FANTASY IV, FINAL FANTASY VII, FINAL FANTASY III, FINAL FANTASY XIII
Dungeons & Dragons Chronicles of Mystara: Dungeons 2, Dungeons & Dragons Online
DOOM 3 BFG Edition: DOOM 3
Nation Red: Red Faction
Warhammer Quest: Warhammer Quest - Base Pack items
Vanguard Princess: Vanguard Princess Director's Cut, Vanguard Princess Hilda Rize, Vanguard Princess Kurumi, Vanguard Princess Lilith
Agarest - Basic Adventure Pack DLC: Agarest - Legendary Adventure Pack DLC, Agarest - Rumored Adventure Pack DLC, Agarest - Jack Pack DLC, Agarest Zero - DLC Pack 1, Agarest Zero - DLC Pack 2, Agarest Zero - DLC Pack 3
Agarest - Dull-Things Pack DLC: Agarest - Jack Pack DLC, Agarest Zero - DLC Pack 1, Agarest Zero - DLC Pack 2, Agarest Zero - DLC Pack 3, Agarest Zero - DLC Pack 4, Agarest Zero - DLC Pack 5
Agarest - Fallen Angel Pack DLC: Agarest - Jack Pack DLC, Agarest Zero - DLC Pack 1, Agarest Zero - DLC Pack 2, Agarest Zero - DLC Pack 3, Agarest Zero - DLC Pack 4, Agarest Zero - DLC Pack 5
Agarest - Legendary-Monster Pack DLC: Agarest - Jack Pack DLC, Agarest Zero - DLC Pack 1, Agarest Zero - DLC Pack 2, Agarest Zero - DLC Pack 3, Agarest Zero - DLC Pack 4, Agarest Zero - DLC Pack 5
Agarest - Magic Fight Pack DLC: Agarest - Jack Pack DLC, Agarest Zero - DLC Pack 1, Agarest Zero - DLC Pack 2, Agarest Zero - DLC Pack 3, Agarest Zero - DLC Pack 4, Agarest Zero - DLC Pack 5
Agarest - Upgrade Pack 1 DLC: Agarest Zero - DLC Pack 1, Agarest - Jack Pack DLC, Agarest - Fishy Pack 1 DLC, Agarest Zero - DLC Pack 2, Agarest Zero - DLC Pack 3, Agarest Zero - DLC Pack 4
PewDiePie Legend of the Brofist: Legend of Fae
Batman Arkham Knight: Batman Arkham City
Batman Arkham Origins -  Online Supply Drop 1: Batman Arkham Origins, Batman Arkham Origins - Online Supply Drop 2, Batman Arkham City, Batman Arkham Origins - Initiation
Batman Arkham Origins Blackgate - Deluxe Edition: Batman Arkham Origins, Batman Arkham City, Batman Arkham Origins - Initiation
Global Agenda: Global Agenda - Beta
Infinity Wars - Animated Trading Card Game: Tap Tap Infinity
Jagged Alliance Online - Steam Edition: Jagged Alliance Gold, TRIP Steam Edition, Jagged Alliance Online Raven Pack
Castlevania Lords of Shadow 2 - Dark Dracula Costume: Castlevania Lords of Shadow 2, Castlevania Lords of Shadow 2 - Armored Dracula Costume
Majesty 2 Collection: Majesty 2
Europa Universalis IV National Monuments II: Europa Universalis IV, Europa Universalis III
Europa Universalis IVNative Americans Unit Pack: Europa Universalis IV, Europa Universalis III
Europa Universalis IV Songs of the New World: Europa Universalis IV, Europa Universalis III, Fate of the World, World of Goo, World of Zoo
Leviathan Warships: Leviathan Warships Commonwealth Unit Pack
Victoria Revolutions: Victoria II
Victoria II Interwar Cavalry Unit Pack: Victoria II
Speedball 2 Tournament: Speedball 2 HD
MoW Face Off M: MoW Face Off XL
Fallout Tactics: Fallout, Fallout 4, Fallout 3, Fallout 2
Call of Duty World at War: Call of Duty, Call of Duty 2, World of Goo, World of Zoo
Dead Rising 2: Dead Rising 2 Off the Record, Dead Rising 3, Dead Rising 3 DLC1, Dead Rising 3 DLC2, Dead Rising 3 DLC3, Dead Rising 3 DLC4
The Bureau XCOM Declassified: The Bureau XCOM Declassified - Code Breakers, The Bureau XCOM Declassified - Light Plasma Pistol
FINAL FANTASY XIV A Realm Reborn: FINAL FANTASY XIV A Realm Reborn (NA version), FINAL FANTASY XIV A Realm Reborn (PAL version), FINAL FANTASY XIV A Realm Reborn CE (NA version), FINAL FANTASY V, FINAL FANTASY XI, FINAL FANTASY IV
DUNGEONS - Steam Special Edition: TRIP Steam Edition, Tropico 3 - Steam Special Edition, Dracula 4 and  5 - Special Steam Edition
Divinity Dragon Commander: Divinity Dragon Commander Beta
Post Apocalyptic Mayhem: Post Apocalyptic Mayhem DLC 2 Chaos Pack
Bionic Commando Rearmed: Bionic Commando
Blackguards: Blackguards 2, Blackguards Untold Legends
MEDIEVAL Total War - Gold Edition: SHOGUN Total War - Gold Edition, Arma Gold Edition
Operation Flashpoint Dragon Rising: Operation Z, Operation Flashpoint Red River
Dragomon Hunter: Dragomon Hunter - Welcome Gift
Chaos on Deponia: Deponia
Goodbye Deponia: Deponia
Baldur's Gate Enhanced Edition: Baldur's Gate II Enhanced Edition
Another World: Alter World
Sid Meier's Pirates!: Sid Meier's Railroads!
Dragon's Lair: Dragon's Lair 2 Time Warp
Edge of Space: Space Legends At the Edge of the Universe
Painkiller Black Edition: Painkiller Gold Edition
Painkiller Resurrection: Painkiller Redemption
Star Trek D-A-C: Star Trek
Stranded Deep: Stranded
Magic Duels: Magic The Gathering - Duels of the Planeswalkers, Magic The Gathering - Duels of the Planeswalkers 2013, Magic The Gathering  Duels of the Planeswalkers 2012
Dragon's Prophet (EU): Dragon's Prophet, Dragon's Prophet Free Starter Pack
East India Company Gold: East India Company, East India Company Pirate Bay, East India Company Privateer
rFactor: rFactor 2, Lifetime Access to Online Services for rFactor 2
Sakura Clicker: Sakura Clicker - Hairstyle Pack, Sakura Clicker - Present Outfit, Sakura Clicker - School Outfit
Car Mechanic Simulator 2015: Car Mechanic Simulator 2015 - PickUp & SUV DLC, Car Mechanic Simulator 2015 - TraderPack, Car Mechanic Simulator 2015 - Visual Tuning, Car Mechanic Simulator 2015 - Youngtimer, Car Mechanic Simulator 2014
AI War Fleet Command: Command HQ
Hearts of Iron III: Hearts of Iron III German II Sprite Pack, Darkest Hour A Hearts of Iron Game, Hearts of Iron II Complete
Civil War II: Star Wolves 3 Civil War, Pinball FX2 - Civil War Table, Battleplan American Civil War, The History Channel Civil War, Ironclads American Civil War
An Alternative Reality The Football Manager Documentary: Football Manager 2013, Football Manager 2011, Football Manager 2012, Football Manager 2015, Football Manager 2014, Football Manager 2016
Ancient Space: Space Ace
Commander Conquest of the Americas Gold: Commander Conquest of the Americas, Commander Conquest of the Americas - Pirate Treasure Chest
Galactic Civilizations II Ultimate Edition: Galactic Civilizations I Ultimate Edition, Galactic Civilizations III
PixelJunk Monsters Ultimate: PixelJunk Shooter Ultimate
Football Manager 2016 Demo: Football Manager 2016, Football Manager 2016 Touch Mode - Design a Son, Football Manager 2013, Football Manager 2011, Football Manager 2012, Football Manager 2015
Secret of the Magic Crystal: Secret of the Magic Crystals - Soundtrack and Coloring Book, Secret of the Magic Crystals - The Race
Batla: Batla - Starter Pack, Batla - Tank
Battle Battalions: Battle Nations
Pro Evolution Soccer 2015: Pro Evolution Soccer 2016, Pro Evolution Soccer 2014, Pro Evolution Soccer 2013, Pro Evolution Soccer 2014 Online Pass, Pro Evolution Soccer 2014 World Challenge DLC, Pro Evolution Soccer 2013 DP DLC
World in Conflict Soviet Assault: World in Conflict
Unreal Tournament 3 Black Edition: Unreal Tournament 2004, Unreal Tournament Game of the Year Edition
Modular Combat: Scraps Modular Vehicle Combat
Escape Rosecliff Island: Escape, Escape Dead Island
Feeding Frenzy 2 Shipwreck Showdown Deluxe: Shipwreck
Zuma Deluxe: Numba Deluxe
Warhammer End Times - Vermintide: Warhammer End Times - Vermintide Sigmar's Blessing
IL-2 Sturmovik Cliffs of Dover: IL-2 Sturmovik 1946
Legends of Aethereus: GT Legends
X Rebirth: X Rebirth The Teladi Outpost, The Binding of Isaac Rebirth, Wanderlust Rebirth
Kingdom Rush: Kingdom, Kingdoms Rise, Kingdoms
Way of the Samurai 4: Total War SHOGUN 2 - Fall of the Samurai, Sword of the Samurai
Kenshi: Mortal Kombat Legacy II - Ep. 4 Kenshi Encounters Ermac
IL-2 Sturmovik Battle of Stalingrad: IL-2 Sturmovik 1946
Divinity Original Sin: Divinity Original Sin Enhanced Edition, Original War
Elemental Fallen Enchantress Map Pack: Fallen Enchantress, Fallen Enchantress Legendary Heroes Map Pack
Racer 8: Ridge Racer Unbounded, Super Laser Racer
Nether: Nether - Believer, Nether Arena, Nether - Chosen
GameMaker Studio: GameMaker Studio Android, GameMaker Studio HTML5, GameMaker Studio Professional, GameMaker Studio Ubuntu Export, GameMaker Studio Standard, GameMaker Studio iOS
Mountain: Mountain Crime Requital, Teddy Floppy Ear - Mountain Adventure
Scourge Outbreak: Scourge Outbreak - Blindside, Scourge Outbreak Fan Pack
Cloudberry Kingdom: Kingdom
Gunman Clive: Gunman Clive 2
RPG Maker 2003: RPG Maker 2000, RPG Maker XP, RPG Maker MV
Tales from the Borderlands: Borderlands, Borderlands 2, Borderlands 2 RU
Moonrise: Moonrise Base Game + Guildmaster's Pack, Moonrise Base Game + Warden's Pack
Joe Danger 2 The Movie: Joe Danger
Pier Solar and the Great Architects: Solar 2
Assassin's Creed Liberation: Assassin's Creed, Assassin's Creed II, Assassin's Creed III, Assassin's Creed Rogue, Assassin's Creed Revelations
BIT.TRIP Presents... Runner2 Future Legend of Rhythm Alien: Legend of Fae
bit Dungeon II: Dungeon Defenders II, Dungeon Nightmares II  The Memory
Crazy Taxi: Taxi
Dark Void: Dark Void Zero
Deadly Premonition The Director's Cut: Deadly 30
Deadly Sin 2: Deadly 30
Deep Dungeons of Doom: Dungeons 2
DOOM II Hell on Earth: DOOM 3
Duke Nukem Manhattan Project: Duke Nukem, Duke Nukem 2, Duke Nukem 3D
Eschalon Book 2: Eschalon Book 1
FATE Undiscovered Realms: FATE
Final DOOM: DOOM 3
Grotesque Tactics 2 - Dungeons and Donuts: Dungeons 2
Grotesque Tactics Evil Heroes: Grotesque Tactics Evil Heroes - Dev
iBomber Defense Pacific: iBomber Defense
Imagine Me: Imagine Earth
KickBeat Steam Edition: TRIP Steam Edition
Legionwood 2 Rise of the Eternal's Realm: Lords of the Realm
Master Levels for DOOM II: DOOM 3
Meltdown: Glacier 3 The Meltdown
On the Rain-Slick Precipice of Darkness, Episode One: On the Rain-Slick Precipice of Darkness, Episode Two
Pier Solar - The Definitive Original Soundtrack: FORCED Original Soundtrack, Solar 2, HuniePop Original Soundtrack, Original War
Return to Castle Wolfenstein: Wolfenstein, Castle, Wolfenstein 3D
Rise of the Triad: Rise of the Triad Dark War
Rollers of the Realm: Lords of the Realm
RPG Maker Futuristic Tiles Resource Pack: RPG Maker DS Resource Pack, RPG Maker DS+ Resource Pack, RPG Maker Royal Tiles Resource Pack, RPG Maker XP, RPG Maker MV, RPG Maker Samurai Resource Pack
RPG Maker High Fantasy Main Party Pack 1: RPG Maker Time Fantasy, RPG Maker XP, RPG Maker MV, RPG Maker High Fantasy 2 Resource Pack
RPG Maker Rural Farm Tiles Resource Pack: RPG Maker DS Resource Pack, RPG Maker DS+ Resource Pack, RPG Maker Royal Tiles Resource Pack, RPG Maker XP, RPG Maker MV, RPG Maker Samurai Resource Pack
RPG Maker Tyler Warren First 50 Battler Pack: RPG Maker XP, RPG Maker MV, RPG Maker Tyler Warren RPG Battlers  2nd 50
RPG Maker Zombie Survival Graphic Pack: RPG Maker XP, RPG Maker MV, I, Zombie
Sacred Citadel: Sacred 3
Sid Meier's Civilization IV Colonization: Sid Meier's Civilization IV, Sid Meier's Civilization V, Sid Meier's Civilization IV Warlords, Sid Meier's Civilization IV Beyond the Sword, Sid Meier's Civilization III Complete
Smugglers 5: Smugglers 5 Invasion
Stealth Bastard Deluxe: Stealth Bastard Deluxe - The Teleporter Chambers
The Retro Expansion: RPG Maker DS+ Expansion - Retro SciFi, The Witcher 3 Wild Hunt - Expansion Pass
Wolfenstein 3D Spear of Destiny: Wolfenstein, Wolfenstein 3D
Ys I: Ys II
Lucius: Lucius II
Cities XXL: Cities XL
Faery - Legends of Avalon: GT Legends
Pro Cycling Manager 2015: Pro Cycling Manager 2013, Pro Cycling Manager 2014, Pro Cycling Manager Season 2008, Pro Cycling Manager Season 2009, Pro Rugby Manager 2015
Runaway The Dream of the Turtle: Dream
Space Run: in Space
King's Bounty Warriors of the North: King's Bounty Warriors of the North - Ice and Fire DLC
Age of Wonders III: Age of Wonders, Age of Wonders 2, Age of Wonders Shadow Magic, Age of Wonders Trilogy Soundtrack
Pinball FX2: Pinball FX2 - Captain America Table, Pinball FX2 - Marvel's Ant-Man, Pinball FX2 - Star Wars Pack, Pinball FX2 - Balls of Glory Pinball, Pinball FX2 - The Walking Dead Table, Pinball FX2 - Core pack
Rocksmith 2014: Rocksmith
CastleStorm: CastleStorm - From Outcast to Savior, CastleStorm - The Warrior Queen, Castle Story
Kings Bounty Legions: King's Bounty Legions | Beast Master Pack
Eador. Masters of the Broken World: Fate of the World, World of Goo, World of Zoo
Fortix: Fortix 2
World of Soccer online: World of Goo, World of Zoo
Particula: Particulars
12 Labours of Hercules III Girl Power: 12 Labours of Hercules
Dream Of Mirror Online: Dream
Overcast - Walden and the Werewolf: Overcast - Walden and the Werewolf - Soundtrack
Ruzh Delta Z: Z
Might & Magic Duel of Champions: Might & Magic Duel of Champions - Christmas Alternate Art Cards Pack
Galaxy on Fire 2 Full HD: Fire
Ballad of Solar: Solar 2
Melissa K. and the Heart of Gold Collector's Edition: Arma Gold Edition
Kingdom Tales 2: Kingdom, Kingdom Tales
Grim Legends 2 Song of the Dark Swan: GT Legends
The Beast of Lycan Isle - Collector's Edition: Nearwood - Collector's Edition
Weather Lord The Successor's Path: The Path
Risen 3 - Titan Lords: Risen
Ghost Encounters Deadwood - Collector's Edition: Nearwood - Collector's Edition
Viking Brothers: Two Brothers
Castle Never Judge a Book by its Cover: Castle
The Clockwork Man: The Clockwork Man The Hidden World
Namariel Legends Iron Lord Premium Edition: GT Legends
Thief - Opportunist: Thief, Thief 2
Thief - Predator: Thief, Thief 2
Thief - The Bank Heist: Thief, Thief 2
Aerena: Serena
Wizardry Online: Wizardry 8
Divinity II - The Dragon Knight Saga: Dragon Age II, Dragon The Game
Tales of Maj'Eyal: Tales of Maj'Eyal - Ashes of Urh'Rok
Carrier Command Gaea Mission: Command HQ
Unity of Command: Command HQ
Drakensang The River of Time: Drakensang
Legend of Dungeon: Legend of Dungeon Masters, Legend of Fae
SpellForce 2 Gold Edition: SpellForce Platinum Edition, Arma Gold Edition
Small World 2: Small World 2 - Be Not Afraid..., Small World 2 - Cursed!, Small World 2 - Grand Dames
Call of Juarez The Cartel: Call of Juarez
Myst Masterpiece Edition: realMyst Masterpiece Edition, Myst V
Riven: Risen
Zombie Army Trilogy: I, Zombie
Death to Spies Moment of Truth: Death to Spies
Pool Nation: Pool Nation FX, Pool Nation - Flair Pack 
Infestation Survivor Stories: Sol Survivor
Europa Universalis Rome - Gold Edition: Europa Universalis IV, Europa Universalis III, Arma Gold Edition, Europa Universalis Rome - Vae Victis
Sword of the Stars II Enhanced Edition: Sword of the Stars The Pit
Airline Tycoon 2: Airline Tycoon Deluxe
Cities XL 2012: Cities XL, Cities XL 2011
Democracy 2: Democracy 3, Democracy 3 Clones and Drones, Democracy 3 Extremism, Democracy 3 Extremism Linux, Democracy 3 Extremism Mac, Democracy 3 Social Engineering
Quake II: Quake, Quake II Ground Zero, Quake II The Reckoning, Quake 4
Quake III Arena: Quake, Quake III Team Arena, Quake 4
Quake Mission Pack 1 Scourge of Armagon: Quake, Quake 4
Quake Mission Pack 2 Dissolution of Eternity: Quake, Quake 4
GooCubelets: GooCubelets 2
Commandos Beyond the Call of Duty: Call of Duty, Call of Duty 2
Depth - S.T.E.V.E. Pack: Depth
RIP: RIP 2 Strike Back, RIP 3 The Last Hero
Soul Gambler: Soul Gambler Artbook & Soundtrack
Why So Evil 2 Dystopia: Why So Evil, Dystopia
Jagged Alliance 2 - Wildfire : Jagged Alliance Gold
The I of the Dragon: Dracula 3 The Path of the Dragon, Garshasp Temple of the Dragon, Dragon The Game
RollerCoaster Tycoon 2 Triple Thrill Pack: RollerCoaster Tycoon, RollerCoaster Tycoon Deluxe
Disney Infinity 2.0: Disney Infinity 3.0 Play Without Limits, Tap Tap Infinity
The Settlers 7 Paths to a Kingdom - Gold Edition: Kingdom, The Settlers 7 Paths to a Kingdom, The Guild Gold Edition, Arma Gold Edition, The Settlers 7 Paths to a Kingdom The Two Kings DLC #4
Kingdom Wars: Kingdom, Kingdom Wars 2 Battles, Kingdoms, Kingdom Tales
Assetto Corsa: Assetto Corsa - Dream Pack 1
Watchmen The End Is Nigh Part 2: Watchmen The End Is Nigh, The Black Watchmen
Port Royale 3: Port Royale 2
FINAL FANTASY XIV Heavensward: FINAL FANTASY V, FINAL FANTASY XI, FINAL FANTASY IV, FINAL FANTASY VII, FINAL FANTASY III, FINAL FANTASY XIII
Stronghold Crusader 2: Stronghold 2, Stronghold Crusader Extreme HD, Stronghold Crusader HD, Stronghold 3, Stronghold HD
Agarest Zero: Agarest Zero - DLC Pack 1, Agarest Zero - DLC Pack 2, Agarest Zero - DLC Pack 3, Agarest Zero - DLC Pack 4, Agarest Zero - DLC Pack 5, Agarest Zero - DLC Pack 7
Cosmonautica: Cosmonautica - Soundtrack
Reverse Crawl: Crawl
Bloodsports.TV: Bloodsports.TV - Blood Brawl
Democracy 3 Social Engineering Mac: Democracy 3, Democracy 3 Social Engineering, Democracy 3 Social Engineering Linux, Democracy 2
Alone in the Dark: Ghost in the Shell Stand Alone Complex First Assault Online, A Walk in the Dark
Crystals of Time: Secret of the Magic Crystals - Soundtrack and Coloring Book, Secret of the Magic Crystals - The Race
Stranded In Time: Stranded
Viscera Cleanup Detail Santa's Rampage: Viscera Cleanup Detail
The Old Tree: The Adventures of Tree
Call of Duty Modern Warfare 2 - Resurgence Pack: Call of Duty Modern Warfare 2, Call of Duty 2, Call of Duty, Call of Duty Modern Warfare 3, Call of Duty 4 Modern Warfare, Call of Duty Modern Warfare 2 - Multiplayer
Call of Duty Modern Warfare 2 Stimulus Package: Call of Duty Modern Warfare 2, Call of Duty 2, Call of Duty, Call of Duty Modern Warfare 3, Call of Duty 4 Modern Warfare, Call of Duty Advanced Warfare
A.R.E.S.: A.R.E.S. Extinction Agenda EX
Grimm: RWBY Grimm Eclipse
Call of Duty United Offensive: Call of Duty, Call of Duty 2
Spirits: 99 Spirits
DeathSpank: DeathSpank Thongs Of Virtue
Tom Clancy's Ghost Recon Future Soldier: Tom Clancy's Ghost Recon
MotoGP14: MotoGP14 Laguna Seca Redbull US Grand Prix DLC, MotoGP13
Influent: Influent DLC - Svenska [Learn Swedish], Influent DLC -  [Learn Japanese], Influent DLC - Franais [Learn French], Influent DLC - English [Learn English]
ArtRage Studio Pro: ArtRage 4
Ether One: Ether One Deluxe Edition Upgrade, Ether One Redux
Grey Goo: Grey Goo - Emergence Campaign, Grey Goo - Soundtrack
Fairy Bloom Freesia: Fairy Bloom Freesia - Original Soundtrack
NBA 2K9: NBA 2K15, NBA 2K16, NBA 2K14, NBA 2K13, NBA 2K10, NBA 2K11
Might & Magic X - Legacy : Elven Legacy Magic
Shelter: Shelter 2, Shelter 2 Soundtrack, Sheltered
Electronic Super Joy: Electronic Super Joy Groove City, Electronic Super Joy Bonus Content
Love: Cube & Star An Arbitrary Love, Our Love Will Grow, Dracula Love Kills
CastleMiner Z: Z
Solar Flux: Solar 2
realMyst: realMyst Masterpiece Edition
Crypt of the Necrodancer Soundtrack: Crypt of the NecroDancer Extended Soundtrack
Crow - Hunter (Trapper Class): Jack - Hunter (Trapper Class)
Slim - Hunter (Medic Class): Emet - Hunter (Medic Class)
Torvald - Hunter (Assault Class): Lennox - Hunter (Assault Class)
Alien Breed 3 Descent: Descent, Descent 3, Descent 2
Ravaged Zombie Apocalypse: Zombie Driver HD Apocalypse Pack, I, Zombie
Obscure: Obscure 2
Storm in a Teacup: Storm
Alien Shooter Vengeance: Alien Shooter
FIFA Manager 10: FIFA Manager 09, FIFA Manager 11
Company of Heroes The Great War 1918: Company of Heroes, Company of Heroes 2, Company of Heroes Europe at War
Sid Meier's Ace Patrol Pacific Skies: Sid Meier's Ace Patrol
Ship Simulator Extremes: World Ship Simulator
Railroad Tycoon 3: Railroad Tycoon 2 Platinum
Cosmic Osmo: Cosmic DJ
Grand Ages Rome: Grand Ages Medieval
Imperium Romanum Gold Edition: Arma Gold Edition
Patrician III: Patrician IV Rise of a Dynasty, Patrician IV Steam Special Edition
Uru Complete Chronicles: Chronicles of a Dark Lord Episode 1 Tides of Fate Complete
Arena Wars 2: Miner Wars Arena 
Order of War: Order of War Challenge
Aggression Europe Under Fire: Fire
Escape Machines: Escape
Axiom Verge: Axiom Verge Original Soundtrack
Mushroom 11: Mushroom Men Truffle Trouble 
Castlevania Lords of Shadow 2 - Revelations DLC: Castlevania Lords of Shadow 2, Revelations 2012, Castlevania Lords of Shadow 2 - Relic Rune Pack
Fallen Enchantress Legendary Heroes Quest Pack: Fallen Enchantress Legendary Heroes, Legendary, Fallen Enchantress, Fallen Enchantress Legendary Heroes Map Pack, Fallen Enchantress Legendary Heroes Loot Pack, Fallen Enchantress Legendary Heroes Leader Pack
Sword of the Stars The Pit - Mind Games: Sword of the Stars The Pit, Sword of the Stars The Pit Gold DLC, Sword of the Stars The Pit - Juggernaut, Sword of the Stars The Pit - Necromancer, Sword of the Stars The Pit Soundtrack
Sword of the Stars Complete Collection: Sword of the Stars The Pit
Aeon Command: Command HQ
The Amazing Spider-Man: The Amazing Spider-Man 2
Apotheon: Apotheon Arena
Platypus II: Platypus
Heavy Fire Afghanistan: Fire
Dragon Age Origins Character Creator: Dragon Age Origins, Dragon Age II
Alien Shooter 2 Conscription: Alien Shooter
Blast Em!: Blast Em! Source Code
CT Special Forces Fire for Effect: Fire, Special Forces Team X
Cult of the Wind: DARK - Cult of the Dead DLC
Neighbours from Hell: Neighbours from Hell 2
Quick Slick Deadly: Deadly 30
Tom Clancy's Ghost Recon Phantoms - EU Looks and Power (Support): Tom Clancy's Ghost Recon Phantoms - EU, Tom Clancy's Ghost Recon, Tom Clancy's Ghost Recon Phantoms - NA Looks and Power (Support), Tom Clancy's Ghost Recon Phantoms - NA, Tom Clancy's Ghost Recon Phantoms - EU Looks and Power (Recon), Tom Clancy's Ghost Recon Phantoms - EU Looks and Power (Assault)
Tom Clancy's Ghost Recon Phantoms - EU Recon Starter Pack: Tom Clancy's Ghost Recon Phantoms - EU, Tom Clancy's Ghost Recon Phantoms - EU Support Starter Pack, Tom Clancy's Ghost Recon Phantoms - EU Assault Starter Pack, Tom Clancy's Ghost Recon, Starter Pack, Tom Clancy's Ghost Recon Phantoms - NA Recon Starter Pack
Tom Clancy's Ghost Recon Phantoms - EU Substance with Style pack (Assault): Tom Clancy's Ghost Recon Phantoms - EU, Tom Clancy's Ghost Recon, Tom Clancy's Ghost Recon Phantoms - NA Substance with Style pack (Assault), Tom Clancy's Ghost Recon Phantoms - NA, Tom Clancy's Ghost Recon Phantoms - EU Substance with Style pack (Recon), Tom Clancy's Ghost Recon Phantoms - EU Substance with Style pack (Support)
Tom Clancy's Ghost Recon Phantoms - EU WAR Madness pack (Assault): Tom Clancy's Ghost Recon Phantoms - EU, Tom Clancy's Ghost Recon, Tom Clancy's Ghost Recon Phantoms - NA WAR Madness pack (Assault), Tom Clancy's Ghost Recon Phantoms - NA, Tom Clancy's Ghost Recon Phantoms - EU WAR Madness pack (Recon), Tom Clancy's Ghost Recon Phantoms - EU WAR Madness pack (Support)
Zombie Shooter: Zombie Shooter 2, I, Zombie
Star Ruler 2: Star Ruler
FX Football - The Manager for Every Football Fan: Football Manager 2013, Football Manager 2011, Football Manager 2012, Football Manager 2015, Football Manager 2014, Football Manager 2016
FaceRig: FaceRig Team Fortress 2 Avatars DLC, FaceRig Pro Upgrade
Cities XL - Limited Edition: Limited Edition, Cities XL
Victory Command: Command HQ
Desktop Dungeons: Desktop Dungeons Goatperson DLC, Desktop Dungeons Soundtrack, Dungeons 2
Naval Warfare: Real Warfare
Construction Simulator 2015 Liebherr 150 EC-B: Construction Simulator 2015 Liebherr LB28, Construction Simulator 2015 Liebherr LR 1300
Brothers in Arms Hell's Highway: Two Brothers
Emergency 2014: Emergency 2012, Emergency 2013
Majesty Gold Edition: Majesty Gold HD, Majesty 2, Arma Gold Edition
Woody Two-Legs Attack of the Zombie Pirates: Zombie Pirates, I, Zombie
Magicka Wizards of the Square Tablet: Magicka, Magicka 2
Cubemen: Cubemen 2
Gumboy Crazy Features: Gumboy Crazy Adventures
Arma Tactics: Arma 2, Arma 3
Between IGF Demo: In Between
Blob From Space: Blob From Space - Please Don't Stop The Music
Chains: The Dark Eye Chains of Satinav
Dungeons The Eye of Draconus: Dungeons 2
Retro/Grade IGF Demo: Retro/Grade
Saints Row IV Inauguration Station: Saints Row IV, Saints Row 2
UFO Afterlight: UFO Afterlight - Old Version
X-Plane 10 Global - 64 Bit: X-Plane 10 Global - 64 Bit - Africa Scenery, X-Plane 10 Global - 64 Bit - Asia Scenery, X-Plane 10 Global - 64 Bit - Australia Scenery, X-Plane 10 Global - 64 Bit - North America Scenery, X-Plane 10 Global - 64 Bit - South America Scenery
Desert Thunder: Desert Gunner
Karos Returns: Karos
Tom Clancy's Ghost Recon Phantoms - EU 6000 GC Pack: Tom Clancy's Ghost Recon Phantoms - EU, Tom Clancy's Ghost Recon, Tom Clancy's Ghost Recon Phantoms - NA, Tom Clancy's Ghost Recon Phantoms - EU Support Starter Pack, Tom Clancy's Ghost Recon Phantoms - EU Assault Starter Pack, Tom Clancy's Ghost Recon Phantoms - EU Recon Starter Pack
Theatre of War: Theatre of War 2 Africa 1943, Theatre of War 3 Korea, Theatre of War 2 Kursk 1943 
Real Warfare 2 Northern Crusades: Real Warfare
The Adventures of Mr. Bobley: The Adventures of Tree
Guns'N'Zombies: Guns'N'Zombies N'Aliens
Rise of Venice: Venice
Descent Underground: Descent, Descent 2, Descent 3
Geometry Wars Retro Evolved: Geometry Wars 3 Dimensions Evolved
Manhunt: Manhunter
Lineage II: Lineage II The Chaotic Throne
Enemy Territory Quake Wars: Quake, Quake 4
Rugby League Team Manager 2015: Pro Rugby Manager 2015
Empires Dawn of the Modern World: Empires, Fate of the World, World of Goo, World of Zoo
Star Wolves: Star Wolves 3 Civil War, Star Wolves 2
Agricultural Simulator 2013 Steam Edition: Agricultural Simulator 2011 Extended Edition, TRIP Steam Edition
Sword Coast Legends: GT Legends
Akaneiro Early Access Starter Pack: Starter Pack, TERA Starter Pack
Company of Heroes 2 - The British Forces: Company of Heroes, Company of Heroes 2
ShootMania Storm: Storm
Bridge Constructor: Bridge Constructor Medieval, Bridge Constructor Playground
Call to Arms: Call to Arms - Deluxe Edition
American Conquest: American Conquest - Fight Back
Dungeons & Dragons Daggerdale: Dungeons 2, Dungeons & Dragons Online
Containment The Zombie Puzzler: I, Zombie
Cosmo's Cosmic Adventure: Cosmic DJ
Dawn of Discovery: Dawn of Discovery - Demo, Dawn of Discovery - Venice
Death Rally (Classic): Death Rally
Iron Warriors T-72 Tank Command: Command HQ
Raptor Call of the Shadows (1994 Classic Edition): Shadows of War, Time of Shadows
Light of Altair: Light
Tropico 5 - Mad World: Tropico 5, Tropico, Tropico 4
NEKOPARA Vol. 1: NEKOPARA Vol. 0
Depth DEV: Depth
Silent Hunter III: Silent Hunter 5 Battle of the Atlantic, Silent Hunter Wolves of the Pacific, Silent Hunter Wolves of the Pacific U-Boat Missions
Freedom Force: Freedom Force vs. the 3rd Reich
Space Quest Collection: King's Quest Collection
FINAL FANTASY XI Ultimate Collection - Abyssea Edition: FINAL FANTASY XI, FINAL FANTASY V, FINAL FANTASY IV, FINAL FANTASY VII, FINAL FANTASY III, FINAL FANTASY XIII
Take Command Second Manassas: Command HQ
From The Depths: Hero Siege - The Depths of Hell (Collector's Edition), Hero Siege - The Depths of Hell
Hero of the Kingdom: Kingdom
Burn Zombie Burn: I, Zombie
Anomaly 2 Soundtrack: Anomaly 2
Anomaly Defenders: Anomaly 2
Avernum Escape From the Pit: Escape, Avernum 4, Avernum 5, Avernum 6
Sacred 3 Underworld Story: Sacred 3
Virtual Villagers A New Home: Home
CSGO Player Profiles: CSGO Player Profiles - Device, CSGO Player Profiles - Edward, CSGO Player Profiles - Fallen, CSGO Player Profiles - Get_Right, CSGO Player Profiles - KennyS, CSGO Player Profiles - Markeloff
CSGO Player Profiles - N0thing: CSGO Player Profiles, CSGO Player Profiles - Taz, CSGO Player Profiles - Device, CSGO Player Profiles - Edward, CSGO Player Profiles - Fallen, CSGO Player Profiles - KennyS
CSGO Player Profiles - Olofmeister: CSGO Player Profiles, CSGO Player Profiles - Taz, CSGO Player Profiles - Device, CSGO Player Profiles - Edward, CSGO Player Profiles - Fallen, CSGO Player Profiles - KennyS
Hacker Evolution Duality: Hacker Evolution, GTR Evolution, BiT Evolution, Evolution RTS, Hacker Evolution - Untold
Heroes of SoulCraft: SoulCraft
Build-A-Lot 4: Build-A-Lot, Build-A-Lot 2, Build-A-Lot 3
Professional Farmer 2014: Professional Farmer 2014 - America DLC
Silverfall: Silverfall Earth Awakening
Heroes Over Europe: Company of Heroes Europe at War
Pacific Storm Allies: Pacific Storm, Storm
A Valley Without Wind: A Valley Without Wind 2
The Journey Down Chapter One: The Journey Down Chapter Two, Down To One
Tom Clancy's Ghost Recon Phantoms - NA Support Starter Pack: Tom Clancy's Ghost Recon Phantoms - NA, Tom Clancy's Ghost Recon Phantoms - NA Recon Starter Pack, Tom Clancy's Ghost Recon, Starter Pack, Tom Clancy's Ghost Recon Phantoms - EU Support Starter Pack, Tom Clancy's Ghost Recon Phantoms - EU Recon Starter Pack
Tom Clancy's Ghost Recon Phantoms - NA The Thrill of the Surprise: Tom Clancy's Ghost Recon Phantoms - NA, Tom Clancy's Ghost Recon, Tom Clancy's Ghost Recon Phantoms - EU The Thrill of the Surprise, Tom Clancy's Ghost Recon Phantoms - EU, Tom Clancy's Ghost Recon Phantoms - NA Recon Starter Pack, Tom Clancy's Ghost Recon Phantoms - EU Recon Starter Pack
Tom Clancy's Ghost Recon Phantoms - NA WAR Madness pack (Recon): Tom Clancy's Ghost Recon Phantoms - NA, Tom Clancy's Ghost Recon, Tom Clancy's Ghost Recon Phantoms - EU WAR Madness pack (Recon), Tom Clancy's Ghost Recon Phantoms - EU, Tom Clancy's Ghost Recon Phantoms - NA WAR Madness pack (Assault), Tom Clancy's Ghost Recon Phantoms - NA WAR Madness pack (Support)
Batman Arkham Asylum: Batman Arkham Asylum GOTY Edition, Batman Arkham City
Xpand Rally Xtreme: Xpand Rally
MotoGP13 2012 Top Riders: MotoGP13
MotoGP13 Moto2 and Moto3: MotoGP13
Pinball FX2 - Earth Defense Table: Pinball FX2, Pinball FX2 - Mars Table
Pinball FX2 - Epic Quest Table: Pinball FX2, Pinball FX2 - Mars Table
Pinball FX2 - Paranormal Table: Pinball FX2, Pinball FX2 - Mars Table
Pinball FX2 - Zen Classics Pack: Pinball FX2
Blitzkrieg Anthology: Blitzkrieg 2 Anthology
MDK: MDK 2
The Void: Over The Void
AquaNox: AquaNox 2 Revelation
SpellForce 2 - Demons of the Past: SpellForce 2 - Demons of the Past - Soundtrack
The Haunted Hells Reach: Haunted
GridRunner Revolution: Revolution Ace
Making History The Great War: Making History II The War of the World
Rex Nebular and the Cosmic Gender Bender: Cosmic DJ
Oscura Lost Light: Light
Chrome: Chrome Specforce
In Between - Soundtrack: In Between
Solar Shifter EX: Solar 2
Star Traders 4X Empires: Empires
Street Fighter X Tekken: Street Fighter IV, Street Fighter V Beta
Castlevania Lords of Shadow  Mirror of Fate HD: Castlevania Lords of Shadow 2
BloodRayne Betrayal: BloodRayne, BloodRayne 2
Pinball FX2 - Doctor Strange Table: Pinball FX2, Pinball FX2 - Mars Table
Pinball FX2 - Excalibur Table: Pinball FX2, Pinball FX2 - Mars Table
Pinball FX2 - Star Wars Pinball Balance of the Force Pack: Pinball FX2, Pinball FX2 - Star Wars Pack, Pinball FX2 - Star Wars Pinball Heroes Within Pack
Real World Racing: Real World Racing Amsterdam & Oakland
Runespell Overture: Overture
Governor of Poker 2 Premium Edition: Governor of Poker 2
Nancy Drew The Deadly Device: Deadly 30
Black Mirror: Black Mirror II
Westward: Westward 3, Westward 2, Westward IV
Ship Simulator Maritime Search and Rescue: World Ship Simulator
Guardians of Graxia: Guardians of Orion
FortressCraft Evolved: FortressCraft Evolved Multiplayer
Skyward Collapse: Collapse
Jagged Alliance 2 Gold Unfinished Business: Jagged Alliance Gold, Jagged Alliance 2 Gold Pack
Blood Bowl 2 - Lizardmen: Blood Bowl 2
Blood Bowl 2 - Wood Elves: Blood Bowl 2
Infected The Twin Vaccine - Collector's Edition: Nearwood - Collector's Edition
Kingdom Elemental: Kingdom
Mainland: Manyland
fault milestone one: fault milestone two sideabove
Shadowgate: Shadowgate MacVenture Series
Deja Vu MacVenture Series: Shadowgate MacVenture Series
007 Legends: GT Legends
Shattered Union: Shattered Horizon
Heroes of Might & Magic V Hammers of Fate: Heroes of Might & Magic V, Might & Magic Heroes VI, Might & Magic Heroes VII , Might & Magic Clash of Heroes, Might & Magic Heroes Online
Dream Pinball 3D: Dream
WRC 5: WRC 5 - WRC Concept Car S
Making History The Calm & The Storm: Storm
Antisquad: Antisquad Tasks in Mexico - the beginning. Tactics FREE DLC, Antisquad - Skirmishes DLC, Antisquad Tasks in Mexico - final. Tactics DLC, Antisquad Tasks in North Korea. Tactics DLC, Antisquad Tasks near the coast of Somalia. Tactics DLC
Quest of Dungeons: Dungeons 2
Teddy Floppy Ear - Kayaking: Teddy Floppy Ear - The Race, Teddy Floppy Ear - Mountain Adventure
Gunspell Steam Edition: TRIP Steam Edition
Journey Of The Light: Light
CAFE 0 ~The Drowned Mermaid~: CAFE 0 ~The Drowned Mermaid~ - Japanese Voice Add-On
Survivor Squad: Squad, Survivor Squad Gauntlets, Sol Survivor
Thank You The Game: Thank You The Game 2
Pinball FX2 - Portal  Pinball: Portal, Pinball FX2, Portal 2
The Golf Club: The Club
Majesty 2 Battles of Ardania: Majesty 2
Majesty 2 Monster Kingdom: Majesty 2, Kingdom
Tropico 5 - Espionage: Tropico 5, Tropico, Tropico 4
Dollar Dash: Dollar Dash DLC1 More Ways to Win, Dollar Dash DLC2 Robbers Tool-Kit
Jagged Alliance Crossfire: Jagged Alliance Gold
OMSI 2: OMSI 2 Add-on Three Generations
The Mysterious Cities of Gold - Secret Paths: Cities XL
Fallout 3 - Mothership Zeta: Fallout 3, Fallout, Fallout 4, Fallout 2
Alien Zombie Megadeath: I, Zombie
Geneforge 5: Geneforge 1, Geneforge 2, Geneforge 3, Geneforge 4
Stubbs the Zombie in Rebel Without a Pulse: I, Zombie
Claire: Claire - Soundtrack
Cooking Academy Fire and Knives: Fire, Run and Fire
Fallout 3 - Point Lookout: Fallout 3, Fallout, Fallout 4, Fallout 2
Fallout 3 - The Pitt: Fallout 3, Fallout, Fallout 4, Fallout 2
Shan Gui: Shan Gui OST
Tcheco in the Castle of Lucio: Castle
Chroma Squad: Squad
Agarest - Carrot-and-Stick Pack DLC: Agarest - Jack Pack DLC, Agarest Zero - DLC Pack 1, Agarest Zero - DLC Pack 2, Agarest Zero - DLC Pack 3, Agarest Zero - DLC Pack 4, Agarest Zero - DLC Pack 5
Agarest - Fishy Pack 2 DLC: Agarest - Fishy Pack 1 DLC, Agarest Zero - DLC Pack 2, Agarest - Jack Pack DLC, Agarest - Additional-Points Pack 2 DLC, Agarest - Additional-PP Pack 2 DLC, Agarest Zero - DLC Pack 1
Agarest - Playful Cat Pack DLC: Agarest - Jack Pack DLC, Agarest Zero - DLC Pack 1, Agarest Zero - DLC Pack 2, Agarest Zero - DLC Pack 3, Agarest Zero - DLC Pack 4, Agarest Zero - DLC Pack 5
Agarest - Rebellious Pack DLC: Agarest - Jack Pack DLC, Agarest Zero - DLC Pack 1, Agarest Zero - DLC Pack 2, Agarest Zero - DLC Pack 3, Agarest Zero - DLC Pack 4, Agarest Zero - DLC Pack 5
Agarest - Seasoned-Breeder Pack DLC: Agarest - Jack Pack DLC, Agarest - Top-Breeder Pack DLC, Agarest Zero - DLC Pack 1, Agarest Zero - DLC Pack 2, Agarest Zero - DLC Pack 3, Agarest Zero - DLC Pack 4
Agarest - Secret-Society Pack DLC: Agarest - Jack Pack DLC, Agarest Zero - DLC Pack 1, Agarest Zero - DLC Pack 2, Agarest Zero - DLC Pack 3, Agarest Zero - DLC Pack 4, Agarest Zero - DLC Pack 5
Agarest - Ultimate Equipment Pack DLC: Agarest - Jack Pack DLC, Agarest Zero - DLC Pack 1, Agarest Zero - DLC Pack 2, Agarest Zero - DLC Pack 3, Agarest Zero - DLC Pack 4, Agarest Zero - DLC Pack 5
Agarest 2 - Bundle #1: Agarest 2 - Bundle #2, Agarest 2 - Bundle #3, Agarest 2 - Bundle #4, Agarest 2 - Bundle #5, Agarest 2 - Bundle #6
Fallen Enchantress Legendary Heroes - Battlegrounds DLC: Fallen Enchantress Legendary Heroes, Legendary, Fallen Enchantress, Fallen Enchantress Legendary Heroes Map Pack, Fallen Enchantress Legendary Heroes Loot Pack, Fallen Enchantress Legendary Heroes Quest Pack
Last Dream: Dream
Silent Storm: Silent Storm Sentinels, Storm
The Settlers Rise of an Empire Gold Edition  : The Guild Gold Edition, Arma Gold Edition
Blood Bowl Dark Elves Edition: Blood Bowl 2, Blood Bowl Chaos Edition
Crusaders Thy Kingdom Come: Kingdom
Blazing Angels Squadrons of WWII: Blazing Angels 2 Secret Missions of WWII
Letter Quest Grimm's Journey: Letter Quest Grimm's Journey Remastered
EverQuest II Rise of Kunark: EverQuest II
EverQuest II The Shadow Odyssey: EverQuest II
Realms of Arkania Blade of Destiny: Realms of Arkania 1 - Blade of Destiny Classic
Caribbean!: Blood & Gold Caribbean!
Legends of Eisenwald: GT Legends
Clockwork Empires: Empires
Community College Hero Trial by Fire: Fire
Damnation City of Death: Damnation
Cognition - Original Soundtrack Vol 1: FORCED Original Soundtrack, HuniePop Original Soundtrack, Original War
Arma X Anniversary Edition: Grandia II Anniversary Edition, Arma Gold Edition, Arma 2, Arma 3
RIDE - 2015 Top Bikes Pack 1: RIDE - 2015 Top Bikes Pack 2
Train Simulator Sheerness Branch Extension Route: Train Simulator
Train Simulator Southern Pacific SD70M Loco: Train Simulator
Brothers in Arms Earned in Blood: Two Brothers
Brothers in Arms Road to Hill 30: Two Brothers
LEGO Indiana Jones The Original Adventures: Original War
System Protocol One: Protocol
Chainsaw Warrior: Chainsaw Warrior Lords of the Night
Mortal Kombat Legacy II - Ep. 1 Reunited in Macau: Mortal Kombat X, Mortal Kombat Legacy - Ep. 6 Raiden, Mortal Kombat Legacy II - Ep. 9 Liu Kang, Mortal Kombat Legacy II - Ep. 6 Johnny Cage
Mortal Kombat Legacy II - Ep. 2 The Fall of Liu Kang: The Fall, Mortal Kombat Legacy II - Ep. 9 Liu Kang, Mortal Kombat X, Mortal Kombat Legacy - Ep. 6 Raiden, Mortal Kombat Legacy II - Ep. 10 Liu Kang and Kung Lao, Mortal Kombat Legacy II - Ep. 6 Johnny Cage
Championship Manager 2008: Championship Manager 2010
One Late Night Deadline: One Night
BIT.TRIP FATE Original Soundtrack: FATE, BIT.TRIP FATE, BIT.TRIP FLUX Soundtrack, FORCED Original Soundtrack, HuniePop Original Soundtrack, Original War
BIT.TRIP FLUX: BIT.TRIP FLUX Soundtrack
Lumines: Lumines Advanced Pack
Elven Legacy: Elven Legacy Magic, Elven Legacy Ranger, Elven Legacy Siege
Wings! Remastered Edition: 8-Bit Adventures The Forgotten Journey Remastered Edition
Etherlords II: Etherlords
Haunted House: Haunted
Putt-Putt Joins the Circus: Putt-Putt Joins the Parade
Freddi Fish 2 The Case of the Haunted Schoolhouse: Haunted
Putt-Putt Goes to the Moon: To the Moon
Nancy Drew Secret of the Scarlet Hand : Nancy Drew Secret of the Old Clock
Delta Force 2: Delta Force Black Hawk Down - Team Sabre, Delta Force Black Hawk Down
Castle of Illusion: Castle
Test Drive Ferrari Racing Legends: GT Legends
Dark Fall 1 The Journal: The Fall
Dreaming Sarah: Dreaming Sarah OST
Hotel Collectors Edition: Aion Collectors Edition
NEON STRUCT: NEON STRUCT Soundtrack & Artbook
Puzzle Kingdoms: Kingdoms, Kingdoms CCG
Safecracker The Ultimate Puzzle Adventure: The Ultimate DOOM
The Joylancer Legendary Motor Knight: Legendary
RPG Maker MV Cover Art Characters Pack: RPG Maker MV, RPG Maker XP
RPG Maker MV Essentials Add-On: RPG Maker MV, RPG Maker XP
One Way To Die Steam Edition: TRIP Steam Edition
MLB 2K12: MLB 2K10, MLB 2K11
Battle Academy: Battle Academy 2 Eastern Front
Storm United: Storm
SuperPower 2 Steam Edition: TRIP Steam Edition
Battle of Empires  1914-1918: Empires
Cricket Revolution: Revolution Ace
Thief Town: Thief, Thief 2
Crazy Machines Golden Gears: Crazy Machines, Crazy Machines 2
Memento Mori 2: Memento Mori
National Zombie Park: I, Zombie
Chicken Shoot 2: Chicken Shoot Gold
TI5 - EG Champions of TI5: Might & Magic Duel of Champions - Christmas Alternate Art Cards Pack
TI5 - Player Profiles Cloud9 - NoTail: CSGO Player Profiles, TI5 - Player Profiles Vici - fy, TI5 - Player Profiles EG - Suma1L, TI5 - Player Profiles LGD - Xiao8, TI5 - Player Profiles Newbee - Mu
TI5 - Player Profiles Complexity - zfreek: CSGO Player Profiles, TI5 - Player Profiles Vici - fy, TI5 - Player Profiles EG - Suma1L, TI5 - Player Profiles LGD - Xiao8, TI5 - Player Profiles Newbee - Mu
TI5 - Player Profiles EHOME - ROTK: CSGO Player Profiles, TI5 - Player Profiles Vici - fy, TI5 - Player Profiles EG - Suma1L, TI5 - Player Profiles LGD - Xiao8, TI5 - Player Profiles Newbee - Mu
TI5 - Player Profiles Empire - Alohadance: CSGO Player Profiles, TI5 - Player Profiles Vici - fy, TI5 - Player Profiles EG - Suma1L, TI5 - Player Profiles LGD - Xiao8, TI5 - Player Profiles Newbee - Mu
TI5 - Player Profiles Fnatic - Kecik-Imba: CSGO Player Profiles, TI5 - Player Profiles Vici - fy, TI5 - Player Profiles EG - Suma1L, TI5 - Player Profiles LGD - Xiao8, TI5 - Player Profiles Newbee - Mu
TI5 - Player Profiles Invictus Gaming - Ferrari: CSGO Player Profiles, TI5 - Player Profiles Vici - fy, TI5 - Player Profiles EG - Suma1L, TI5 - Player Profiles LGD - Xiao8, TI5 - Player Profiles Newbee - Mu
TI5 - Player Profiles MVPHot6 - HEEN: CSGO Player Profiles, TI5 - Player Profiles Vici - fy, TI5 - Player Profiles EG - Suma1L, TI5 - Player Profiles LGD - Xiao8, TI5 - Player Profiles Newbee - Mu
TI5 - Player Profiles NAVI - XBOCT: CSGO Player Profiles, TI5 - Player Profiles Vici - fy, TI5 - Player Profiles EG - Suma1L, TI5 - Player Profiles LGD - Xiao8, TI5 - Player Profiles Newbee - Mu
TI5 - Player Profiles TeamSecret - S4: CSGO Player Profiles, TI5 - Player Profiles Vici - fy, TI5 - Player Profiles EG - Suma1L, TI5 - Player Profiles LGD - Xiao8, TI5 - Player Profiles Newbee - Mu
TI5 - Player Profiles VirtusPro - FNG: CSGO Player Profiles, TI5 - Player Profiles Vici - fy, TI5 - Player Profiles EG - Suma1L, TI5 - Player Profiles LGD - Xiao8, TI5 - Player Profiles Newbee - Mu
Hard Truck Apocalypse / Ex Machina: Hard Truck Apocalypse Rise Of Clans / Ex Machina Meridian 113
The Campaign Series Fall Weiss: The Fall
Cast of the Seven Godsends: Cast of the Seven Godsends - Soundtrack
Escape Goat: Escape, Escape Goat 2
Arsenal of Democracy: Democracy 3, Democracy 2
Depth Hunter 2 Ocean Mysteries: Depth
Heroes of Annihilated Empires: Empires
NecroVisioN Lost Company: NecroVisioN
Space Station Alpha: Environmental Station Alpha
Storm over the Pacific: Pacific Storm, Storm
Tom Clancy's Ghost Recon Desert Siege: Tom Clancy's Ghost Recon
Tom Clancy's Ghost Recon Island Thunder: Tom Clancy's Ghost Recon
World War 2 Time of Wrath: World of Goo, World of Zoo
Zoo Park: Wildlife Park 2 - Crazy Zoo
Wizardry 7 Crusaders of the Dark Savant: Wizardry 8
Tryst: Tryst Survival DLC
Zombie Tycoon 2 Brainhov's Revenge: I, Zombie
Seven Kingdoms 2 HD: Kingdoms, Kingdoms CCG
Agarest - Additional-Points Pack 3 DLC: Agarest - Additional-Points Pack 2 DLC, Agarest - Additional-Points Pack 4 DLC, Agarest Zero - DLC Pack 3, Agarest - Additional-PP Pack 1 DLC, Agarest - Additional-PP Pack 2 DLC, Agarest - Additional-TP Pack DLC
Agarest - Unlock Gallery DLC: Agarest - Unlock Voices DLC
Avernum 2 Crystal Souls: Avernum 4, Avernum 5, Avernum 6
Realms of Arkania 2 - Star Trail Classic: Realms of Arkania 1 - Blade of Destiny Classic, Realms of Arkania 3 - Shadows over Riva Classic
Space Rangers 2 Reboot: Space Rangers
The Book of Legends: GT Legends
Undefeated: Undefeated - Deluxe Contents, Undefeated - Official Guide
Warhammer 40,000 Storm of Vengeance Death Skulls Clan: Warhammer 40,000 Storm of Vengeance, Storm, Warhammer 40,000 Storm of Vengeance Bad Moon Clan
Warhammer 40,000 Storm of Vengeance Imperial Guard Faction: Warhammer 40,000 Storm of Vengeance, Storm, Warhammer 40,000 Storm of Vengeance Bad Moon Clan
Carnage Racing: Bang Bang Racing
RPG Maker Arabian Nights: RPG Maker XP, RPG Maker MV
RPG Maker Classic Fantasy Music Pack: RPG Maker Time Fantasy, RPG Maker XP, RPG Maker MV
RPG Maker Old School Modern Resource Pack: RPG Maker DS Resource Pack, RPG Maker DS+ Resource Pack, RPG Maker XP, RPG Maker MV, RPG Maker Samurai Resource Pack
Children of the Nile Alexandria: Children of the Nile
Miner Wars 2081: Miner Wars Arena 
The Stalin Subway: The Stalin Subway Red Veil
Warehouse and Logistics Simulator: Warehouse and Logistics Simulator DLC Hell's Warehouse
Zombie Bowl-O-Rama: I, Zombie
GameMaker Studio Windows Phone 8: GameMaker Studio, GameMaker Studio iOS, GameMaker Studio HTML5, GameMaker Studio Android
GameMaker Studio YoYo Compiler: GameMaker Studio, GameMaker Studio iOS, GameMaker Studio HTML5, GameMaker Studio Android
Pinball FX2 - Marvel Pinball Avengers Chronicles pack: Pinball FX2, Pinball FX2 - Core pack
Pinball FX2 - Marvel Pinball Original Pack: Pinball FX2, Original War
Wildlife Park 2 - Fantasy: Wildlife Park 2, Wildlife Park 3, Wildlife Park 2 - Horses, Wildlife Park 2 - Marine World, Wildlife Park 2 - Dino World, Wildlife Park 2 - Crazy Zoo
TyranoBuilder Visual Novel Studio: TyranoBuilder Visual Novel Studio Demo
Dream Tale: Dream
RPG Maker Mythos Horror Resource Pack: RPG Maker DS Resource Pack, RPG Maker DS+ Resource Pack, RPG Maker XP, RPG Maker MV, RPG Maker Samurai Resource Pack
Volume: BookWorm Adventures Volume 2
Warhammer 40,000 Armageddon: Warhammer 40,000 Armageddon - Angels of Death, Warhammer 40,000 Armageddon - Glory of Macragge, Warhammer 40,000 Armageddon - Untold Battles, Warhammer 40,000 Armageddon - Vulkan's Wrath
Shadow of Kingdoms: Kingdoms, Kingdoms CCG
Tom Clancy's Ghost Recon Phantoms - NA Substance with Style pack (Support): Tom Clancy's Ghost Recon Phantoms - NA, Tom Clancy's Ghost Recon, Tom Clancy's Ghost Recon Phantoms - EU Substance with Style pack (Support), Tom Clancy's Ghost Recon Phantoms - EU, Tom Clancy's Ghost Recon Phantoms - NA Substance with Style pack (Recon), Tom Clancy's Ghost Recon Phantoms - NA Substance with Style pack (Assault)
RPG Maker Inspirational Vol. 2: RPG Maker XP, RPG Maker MV
RPG Maker The Simple Life Music Pack: RPG Maker XP, RPG Maker MV
World of Mixed Martial Arts 3: World of Goo, World of Zoo
The Sacred Tears TRUE: Sacred 3
European Ship Simulator: World Ship Simulator
Flashback: Jagged Alliance Flashback
Frontline Tactics - Snow Camouflage : Frontline Tactics, Frontline Tactics - Desert Camouflage, Frontline Tactics - Ninja Camouflage, Frontline Tactics - Tiger Camouflage, Frontline Tactics - Woodland Camouflage, Frontline Tactics - Sniper
Tropico 5 - Inquisition: Tropico 5, Tropico, Tropico 4
3DMark 11: 3DMark, 3DMark API Overhead feature test, 3DMark Cloud Gate benchmark, 3DMark Fire Strike benchmark, 3DMark Ice Storm benchmark, 3DMark Sky Diver benchmark
Planet Stronghold: Stronghold 3, Stronghold 2, Stronghold HD
FINAL FANTASY IV THE AFTER YEARS: FINAL FANTASY IV, FINAL FANTASY V, FINAL FANTASY XI, FINAL FANTASY VII, FINAL FANTASY III, FINAL FANTASY XIII
Raiden Legacy: Mortal Kombat Legacy - Ep. 6 Raiden
Voyage Journey to the Moon: To the Moon
Pahelika Secret Legends: GT Legends
Lords of the Realm III: Lords of the Realm, Lords of the Realm II
Puzzle Quest Galactrix: Puzzle Quest, Puzzle Quest 2
Bullet Heaven 2: Bullet Heaven 2 - Soundtrack
Over the Dream: Dream
STAR WARS TIE Fighter Special Edition: STAR WARS X-Wing Special Edition
Wildlife Park 2 - Domestic Animals DLC: Wildlife Park 2, Wildlife Park 3, Wildlife Park 2 - Horses, Wildlife Park 2 - Fantasy
Wildlife Park 2 - Farm World: Wildlife Park 2, Wildlife Park 3, Wildlife Park 2 - Marine World, Wildlife Park 2 - Dino World, Wildlife Park 2 - Horses, Wildlife Park 2 - Fantasy
Midnight Mysteries 4 Haunted Houdini: Haunted
Jack Keane: Jack Keane 2 - The Fire Within
1701 A.D. Gold Edition: Arma Gold Edition
Pinball FX2 - Super League - Zen Studios F.C. Table: Pinball FX2, Pinball FX2 - Mars Table
Alien Shooter Revisited: Alien Shooter
Battle Brothers: Two Brothers
Nancy Drew The Haunted Carousel: Haunted
Kuros: Karos
Dream Chronicles The Chosen Child: Dream
Nancy Drew Legend of the Crystal Skull : Legend of Fae
Nancy Drew The Haunting of Castle Malloy: Castle
Nancy Drew The Phantom of Venice: Venice
Tesla Breaks the World!: Tesla Breaks the World! Official Soundtrack
The Counting Kingdom: Kingdom
Romance of the Three Kingdoms Maker: Kingdoms, Kingdoms CCG
